1. 关于施工一般特种作业人员应具备条件的说法，正确的是{{c1::（）}}。[2014年真题]	年满16周岁，且不超过国家法定退休年龄<br>必须为男性<br>连续从事本工种10年以上<br>具有初中及以上文化程度	D	特种作业人员应具备的条件有：①年满18周岁，且不超过国家法定退休年龄。②经社区或者县级以上医疗机构体检健康合格，并无妨碍从事相应特种作业的器质性心脏病、癫痫病、美尼尔氏症、眩晕症、癔病、震颤麻痹症、精神病、痴呆症以及其他疾病和生理缺陷。③具有初中及以上文化程度。④具备必要的安全技术知识与技能。⑤相应特种作业规定的其他条件。危险化学品特种作业人员除符合上述第①项、第②项、第④项和第⑤项规定的条件外，应当具备高中或者相当于高中及以上文化程度。
2. 建筑施工企业的三级安全教育是指{{c1::（）}}。［2009年真题］	公司层教育、项目部教育、作业班组教育<br>进场教育、作业前教育、上岗教育<br>最高领导教育、项目经理教育、班组长教育<br>最高领导教育、生产负责人教育、项目经理教育	A	新员工上岗前的三级安全教育，通常是指进厂、进车间、进班组三级，对建设工程来说，具体指企业（公司）、项目（或工区、工程处、施工队）、班组三级。
3. 施工企业安全检查制度中，安全检查的重点是检查“三违”和{{c1::（）}}落实。[2014年真题]	施工起重机械的使用登记制度<br>安全责任制<br>现场人员的安全教育制度<br>专项施工方案专家论证制度	B	安全检查的内容包括查思想、查制度、查管理、查隐患、查整改、查伤亡事故处理等。安全检查的重点是检查“三违”和安全责任制的落实。检查后应编写安全检查报告，报告应包括已达标项目、未达标项目、存在问题、原因分析、纠正和预防措施等内容。
4. 根据《建筑法》，建筑施工企业可以自主决定是否投保的险种是{{c1::（）}}。[2015年真题]	基本医疗保险<br>工伤保险<br>意外伤害保险<br>失业保险	C	修正后的《建筑法》与修订后的《社会保险法》和《工伤保险条例》等法律法规的规定保持一致，明确了建筑施工企业作为用人单位，为职工参加工伤保险并交纳工伤保险费是其应尽的法定义务，但为从事危险作业的职工投保意外伤害险并非强制性规定，是否投保意外伤害险由建筑施工企业自主决定。
5. 下列风险控制方法中，适用于第一类风险源控制的是{{c1::（）}}。[2015年真题]	提高各类设施的可靠性<br>设置安全监控系统<br>隔离危险物质<br>加强员工的安全意识教肓	C	第一类危险源控制方法包括消除危险源、限制能量和隔离危险物质、个体防护、应急救援等。建设工程可能遇到不可预测的各种自然灾害引发的风险，只能采取预测、预防、应急计划和应急救援等措施，以尽量消除或减少人员伤亡和财产损失。
6. 施工过程中发现问题及时处理，是施工安全隐患处理原则中{{c1::（）}}原则的体现。[2014年真题]	动态处理<br>重点处理<br>预防与减灾并重<br>冗余安全度处理	A	动态治理就是对生产过程进行动态随机安全化治理，生产过程中发现问题及时治理，既可以及时消除隐患，又可以避免小的隐患发展成大的隐患。
7. {{c1::（）}}是最基本的安全管理制度，是所有安全生产管理制度的核心。	政府安全生产监督检查制度<br>安全生产许可证制度<br>安全生产责任制<br>安全生产教育培训制度	C	安全生产责任制是最基本的安全管理制度，是所有安全生产管理制度的核心。安全生产责任制是按照安全生产管理方针和“管生产的同时必须管安全”的原则，将各级负责人员、各职能部门及其工作人员和各岗位生产工人在安全生产方面应做的事情及应负的责任加以明确规定的一种制度。
8. 某建筑工程建筑面积为3万m2，按照安全生产责任制度，应配备的专职安全人员的人数为{{c1::（）}}名。	1<br>1～2<br>2～3<br>3～4	C	按照安全生产责任制的相关规定，施工现场应按工程项目大小配备专（兼）职安全人员。建筑工程按建筑面积1万平方米以下的工地至少有一名专职人员；1万平方米以上的工地设2～3名专职人员；5万平方米以上的大型工地，按不同专业组成安全管理组进行安全监督检查。
9. 负责对本行政区域内建设工程安全生产工作实施综合监督管理的机构是{{c1::（）}}。	县级以上地方人民政府<br>省、自治区、直辖市人民政府<br>县级以上地方人民政府安全生产监督管理部门<br>县级以上地方人民政府建设行政主管部门	C	依据《建设工程安全生产管理条例》第五章“监督管理”对建设工程安全监督管理的规定，县级以上地方人民政府负责安全生产监督管理的部门对本行政区域内建设工程安全生产工作实施综合监督管理，同级建设行政主管部门对本行政区域内建设工程安全生产实施监督管理。
10. 特种作业具备的特点不包括{{c1::（）}}。	复杂性<br>独立性<br>危险性<br>特殊性	A	特种作业具备的特点主要包括：①独立性，必须有独立的岗位，由专人操作的作业，操作人员必须具备一定的安全生产知识和技能。②危险性，必须是危险性较大的作业，如果操作不当，容易对操作者本人、他人或物造成伤害，甚至发生重大伤亡事故。③特殊性，从事特种作业的人员不能很多，总体上讲，每个类别的特种作业人员一般不超过该行业或领域全体从业人员的30％。
11. 特种作业操作证每{{c1::（）}}年复审1次。	3<br>5<br>6<br>10	A	取得操作证特种作业人员，必须定期进行复审。特种作业操作证每3年复审1次。特种作业人员在特种作业操作证有效期内，连续从事本工种10年以上，严格遵守有关安全生产法律法规的，经原考核发证机关或者从业所在地考核发证机关同意，特种作业操作证的复审时间可以延长至每6年1次。
12. 根据相关规定，项目级安全教育的组织实施者为{{c1::（）}}。	项目级负责人<br>企业主管领导<br>专职安全员<br>班组长	A	根据《建设工程安全生产管理条例》的有关规定，企业（公司）级安全教育由企业主管领导负责，企业职业健康安全管理部门会同有关部门组织实施；项目（或工区、工程处、施工队）级安全教育由项目级负责人组织实施，专职或兼职安全员协助；班组级安全教育由班组长组织实施。
13. 企业进行生产活动时，必须编制安全措施计划，其编写步骤为{{c1::（）}}。	危险源识别→工作活动分类→风险确定→风险评价→制定安全技术措施计划→评价安全技术措施计划的充分性<br>工作活动分类→危险源识别→风险确定→风险评价→评价安全技术措施计划的充分性→制定安全技术措施计划<br>危险源识别→工作活动分类→风险确定→风险评价→评价安全技术措施计划的充分性→制定安全技术措施计划<br>工作活动分类→危险源识别→风险确定→风险评价→制定安全技术措施计划→评价安全技术措施计划的充分性	D	安全宣传教育措施是为了宣传普及有关安全生产法律、法规、基本知识所需要的措施，其主要内容包括：安全生产教材、图书、资料，安全生产展览，安全生产规章制度，安全操作方法训练设施，劳动保护和安全技术的研究与实验等。安全技术措施计划编制可以按照“工作活动分类→危险源识别→风险确定→风险评价→制定安全技术措施计划评价→安全技术措施计划的充分性”的步骤进行。
14. 关于特种作业操作资格证书的规定，下列说法有误的是{{c1::（）}}。	特种作业操作资格证书在全国范围内有效<br>特种作业操作证，每3年复审一次。连续从事本工种10年以上的，经用人单位进行知识更新教育后，复审时间可延长至每6年一次<br>离开特种作业岗位达3个月以上的特种作业人员，应当重新进行实际操作考核，经确认合格后方可上岗作业<br>垂直运输机械作业人员、爆破作业人员、登高架设作业人员等特种作业人员，必须按照国家有关规定经过专门的安全作业培训，并取得特种作业操作资格证书后，方可上岗作业	C	C项，离开特种作业岗位达6个月以上的特种作业人员，应当重新进行实际操作考核，经确认合格后方可上岗作业。
15. 下列关于严重危及施工安全的工艺、设备、材料淘汰制度的说法中，正确的是{{c1::（）}}。	国家对严重危及施工安全的工艺、设备、材料实行淘汰制度<br>严重危及施工安全的工艺、设备、材料名单由国务院质量技术监督管理部门负责制定并公布<br>对于已经公布的严重危及施工安全的工艺、设备和材料，建设单位和施工单位不得继续使用，但可以转让<br>严重危及施工安全的工艺、设备、材料是指不符合质量要求的工艺、设备和材料	A	B项，国家对严重危及施工安全的工艺、设备、材料实行淘汰制度。具体目录由国务院建设行政主管部门会同国务院其他有关部门制定并公布。C项，对于已经公布的严重危及施工安全的工艺、设备和材料，建设单位和施工单位都应当严格遵守和执行，不得继续使用此类工艺和设备，也不得转让他人使用。D项，严重危及施工安全的工艺、设备、材料是指不符合生产安全要求，极有可能导致生产安全事故发生，致使人民生命和财产遭受重大损失的工艺、设备和材料。
16. 施工单位应当自施工起重机械和整体提升脚手架、模板等自升式架设设施验收合格之日起{{c1::（）}}日内，向建设行政主管部门或者其他有关部门登记。	15<br>30<br>40<br>60	B	《建设工程安全生产管理条例》第三十五条规定，施工单位应当自施工起重机械和整体提升脚手架、模板等自升式架设设施验收合格之日起三十日内，向建设行政主管部门或者其他有关部门登记。登记标志应当置于或者附着于该设备的显著位置。
17. 对危及人身安全的紧急险情，应立即停工，并按照以下{{c1::（）}}程序处理安全隐患。	整改→登记→复查→销案<br>登记→复查→整改→销案<br>登记→整改→复查→销案<br>整改→复查→登记→销案	C	安全隐患的处理程序包括：对查出的安全隐患，不能立即整改的，要制定整改计划，定人、定措施、定经费、定完成日期；在未消除安全隐患前，必须采取可靠的防范措施，如有危及人身安全的紧急险情，应立即停工；并应按照“登记→整改→复查→销案”的程序处理安全隐患。
18. 下列做法中，不符合生产安全事故报告和调查处理制度规定的是{{c1::（）}}。	生产经营单位发生生产安全事故后，事故现场有关人员应当立即报告本单位负责人<br>施工中发生事故时，建筑施工企业应当采取紧急措施减少人员伤亡和事故损失，并按照国家有关规定及时向有关部门报告<br>施工单位发生生产安全事故，应当按照国家有关伤亡事故报告和调查处理的规定，及时、如实地向负责安全生产监督管理的部门、建设行政主管部门或者其他有关部门报告<br>特种设备发生事故，事故发生单位按照国家有关规定，及时、如实地向负有安全生产监督管理职责的部门和省级安全监督管理部门等有关部门报告	D	D项，特种设备发生事故，事故发生单位应当迅速采取有效措施，组织抢救，防止事故扩大，减少人员伤亡和财产损失，并按照国家有关规定，及时、如实地向负有安全生产监督管理职责的部门和特种设备安全监督管理部门等有关部门报告。不得隐瞒不报、谎报或者拖延不报。
19. 造成约束、限制能量和危险物质措施失控的各种不安全因素称作{{c1::（）}}。	危险源<br>第一类危险源<br>第二类危险源<br>第三类危险源	C	造成约束、限制能量和危险物质措施失控的各种不安全因素称作第二类危险源。第二类危险源主要体现在设备故障或缺陷（物的不安全状态）、人为失误（人的不安全行为）和管理缺陷等几个方面。
20. 危险源识别常采用专家调查法，下列各项中属于专家调查法的是{{c1::（）}}。	德尔菲法<br>危险与操作性研究法<br>安全检查表法<br>事故树分析法	A	危险源识别有多种方法，常用的有专家调查法和安全检查表法，属于专家调查法的有头脑风暴法和德尔菲法。
21. 在风险等级评估中，中等轻度损失属于{{c1::（）}}。	Ⅰ—可忽略风险<br>Ⅱ—可容许风险<br>Ⅲ—中度风险<br>Ⅳ—重大风险	B	风险评价是一个持续不断的过程，应持续评审控制措施的充分性。当条件变化时，应对风险重新评估。风险等级评估表如表2Z105020所示。表中，Ⅰ表示可忽略风险；Ⅱ表示可容许风险；Ⅲ表示中度风险；Ⅳ表示重大风险；Ⅴ表示不容许风险。<br/><img height="173" src="http://admintk.100xuexi.com/UpLoadImage/2013-05-07/e4e1485f-022a-4dc6-aed1-ad5bacd9d138.png" width="709"/>
22. 对不同风险水平的风险，应采取不同的措施，下列措施错误的是{{c1::（）}}。	对于可忽略的风险，不采取措施且不必保留文件记录<br>对于可容许的风险，不需要另外的控制措施，应考虑投资效果更佳的解决方案或不增加额外成本的改进措施，需要监视来确保控制措施得以维持<br>对于中度的风险，应努力降低风险，但应仔细测定并限定预防成本，并在规定的时间期限内实施降低风险的措施<br>对于重大的风险，只有当风险已经降低时，才能开始或继续工作。如果无限的资源投入也不能降低风险，就必须禁止工作	D	D项，对于重大的风险，直至风险降低后才能开始工作。为降低风险有时必须配给大量的资源。当风险涉及正在进行中的工作时，就应采取应急措施。对于不容许的风险，只有当风险已经降低时，才能开始或继续工作。如果无限的资源投入也不能降低风险，就必须禁止工作。
23. 建设工程的风险控制方法中，属于第一类危险源控制方法的是{{c1::（）}}。	应急救援<br>加强员工的安全意识培训和教育<br>改善作业环境<br>设置安全监控系统	A	建设工程的风险控制方法中，第一类危险源控制方法包括：采取消除危险源、限制能量和隔离危险物质、个体防护、应急救援等方法。建设工程可能遇到不可预测的各种自然灾害引发的风险，只能采取预测、预防、应急计划和应急救援等措施，以尽量消除或减少人员伤亡和财产损失。BCD三项属于第二类危险源控制方法。
24. 施工安全隐患一般包括人的不安全行为、物的不安全状态以及{{c1::（）}}。	环境不利<br>突发事件<br>不可抗力<br>管理不当	D	施工安全隐患，是指在建筑施工过程中，给生产施工人员的生命安全带来威胁的不利因素，一般包括人的不安全行为、物的不安全状态以及管理不当等。
25. 某工地发生触电事故，一方面要进行人的安全用电操作教育，同时现场也要设置漏电开关，对配电箱、用电电路进行防护改造，也要严禁非专业电工乱接乱拉电线，这体现了{{c1::（）}}。	冗余安全度处理原则<br>单项隐患综合处理原则<br>直接隐患与间接隐患并治原则<br>预防与减灾并重处理原则	B	根据单项隐患综合处理原则，人、机、料、法、环境五者任一环节产生安全隐患，都要从五者安全匹配的角度考虑，调整匹配的方法，提高匹配的可靠性。一件单项隐患问题的整改需综合（多角度）处理。人的隐患，既要治人也要治机具及生产环境等各环节。例如某工地发生触电事故，一方面要进行人的安全用电操作教育，同时现场也要设置漏电开关，对配电箱、用电电路进行防护改造，也要严禁非专业电工乱接乱拉电线。
