1. 根据《建筑业企业资质管理规定》，关于施工企业资质证书的说法，正确的是{{c1::（）}}。[2017年真题]	资质许可机关未在企业资质证书有效期届满前作出是否准予延续资质证书决定的，视为不准予延续<br>企业发生合并、分立、重组以及改制等事项，可以直接承继原施工企业资质<br>资质证书有效期届满，未依法申请延续的，资质许可机关应当撤回其资质证书<br>项目未取得施工许可证，施工企业擅自施工的，资质许可机关不予批准该施工企业的资质升级申请和增项申请	D	A项，资质许可机关应当在建筑业企业资质证书有效期届满前做出是否准予延续的决定；逾期未做出决定的，视为准予延续；B项，企业发生合并、分立、重组以及改制等事项，需承继原建筑业企业资质的，应当申请重新核定建筑业企业资质等级；C项，资质证书有效期届满，未依法申请延续的情形，资质许可机关应当依法注销建筑业企业资质，并向社会公布其建筑业企业资质证书作废；D项，企业申请建筑业企业资质升级、资质增项，在申请之日起前一年至资质许可决定作出前，有未取得施工许可证擅自施工的情况的，资质许可机关不予批准其建筑业企业资质升级申请和增项申请。
2. 某建设工程施工招标，甲公司中招后将其转包给不具有相应资质等级的乙公司，乙施工过程不符合规定的质量标准，给建设单位造成损失。关于向建设单位承担赔偿责任的说法，正确的是{{c1::（）}}。[2017年真题]	甲、乙承担连带赔偿责任<br>建设单位与甲有合同关系，应由甲承担赔偿责任<br>乙为实际施工人，应由乙承担赔偿责任<br>甲和乙承担按份赔偿责任	A	《建筑法》规定，承包单位将承包的工程转包的，或者违反本法规定进行分包的，责令改正，没收违法所得，并处罚款，可以责令停业整顿，降低资质等级；情节严重的，吊销资质证书。承包单位有以上规定的违法行为的，对因转包工程或者违法分包的工程不符合规定的质量标准造成的损失，与接受转包或者分包的单位承担连带赔偿责任。
3. 下列承揽工程的情形中，符合工程承包管理相关规定的是{{c1::（）}}。［2013年真题］	超越本企业资质等级许可的业务范围承揽工程<br>分公司使用总公司的营业执照及资质证书承揽工程<br>以联营方式使用其他施工企业的营业执照及资质证书承揽工程<br>子公司使用总公司的营业执照及资质证书承揽工程	B	A项，禁止建筑施工企业超越本企业资质等级许可的业务范围或者以任何形式用其他建筑施工企业的名义承揽工程。C项，禁止建筑施工企业以任何形式允许其他单位或者个人使用本企业的资质证书、营业执照，以本企业的名义承揽工程。BD两项，分公司可以使用总公司的营业执照及资质证书承揽工程。而子公司具有独立法人资格，应以自己的名义开展经营活动，独立承担公司行为的后果和责任，不得使用总公司的营业执照及资质证书承揽工程。
4. 根据工程承包相关法律规定，建筑业企业{{c1::（）}}承揽工程。［2010年真题］	可以超越本企业资质等级许可的业务范围<br>可以另一个建筑施工企业的名义<br>只能在本企业资质等级许可的业务范围内<br>可允许其他单位或者个人使用本企业的资质证书	C	《建筑法》规定，禁止建筑施工企业超越本企业资质等级许可的业务范围或者以任何形式用其他建筑施工企业的名义承揽工程。
5. 按照《建筑法》规定，以下说法正确的是{{c1::（）}}。［2009年真题］	建筑企业集团公司可以允许所属法人公司以其名义承揽工程<br>建筑企业可以在其资质等级之上承揽工程<br>联合体共同承包的，按照资质等级高的单位的业务许可范围承揽工程<br>施工企业不允许将承包的全部建筑工程转包给他人	D	AB两项，根据《建筑法》第二十六条，禁止建筑施工企业超越本企业资质等级许可的业务范围或者以任何形式用其他建筑施工企业的名义承揽工程。禁止建筑施工企业以任何形式允许其他单位或者个人使用本企业的资质证书、营业执照，以本企业的名义承揽工程。C项，第二十七条规定，两个以上不同资质等级的单位实行联合共同承包的，应当按照资质等级低的单位的业务许可范围承揽工程。
6. 根据《建筑业企业资质管理规定》，施工企业隐瞒相关情况或提供虚假材料申请建筑业企业资质的，不予受理并给予警告，申请人在{{c1::（）}}内不得再次申请。[2015年真题]	4年<br>3年<br>2年<br>1年	D	《建筑业企业资质管理规定》第三十五条规定，申请企业隐瞒有关真实情况或者提供虚假材料申请建筑业企业资质的，资质许可机关不予许可，并给予警告，申请企业在1年内不得再次申请建筑业企业资质。
7. 关于施工企业违法行为应承担法律责任的说法，正确的是{{c1::（）}}。[2015年真题]	超越本单位资质等级承揽工程的，责令停止违法行为并降低资质等级<br>将承包的工程转包的，责令改正并没收违法所得<br>未取得资质证书承揽工程的，予以取缔，并处罚款；有违法所得的，予以没收<br>允许他人以本企业名义承揽工程的，没收违法所得并处罚款和吊销资质证书	C	A项，《建筑法》规定，超越本单位资质等级承揽工程的，责令停止违法行为，处以罚款，可以责令停业整顿，降低资质等级；情节严重的，吊销资质证书；有违法所得的，予以没收。B项，承包单位将承包的工程转包的，或者违反《建筑法》规定进行分包的，责令改正，没收违法所得，并处罚款，可以责令停业整顿，降低资质等级；情节严重的，吊销资质证书。C项，未取得资质证书承揽工程的，予以取缔，并处罚款；有违法所得的，予以没收。D项，建筑施工企业转让、出借资质证书或者以其他方式允许他人以本企业的名义承揽工程的，责令改正，没收违法所得，并处罚款，可以责令停业整顿，降低资质等级；情节严重的，吊销资质证书。
8. 某建设工程项目，甲公司中标后将其转包给不具有相应资质等级的乙公司，乙公司施工工程不符合规定质量标准，给建设单位造成损失，下列说法中，正确的是{{c1::（）}}。[2015年真题]	建设单位与甲公司有直接合同关系，应由甲公司承担赔偿责任<br>甲、乙承担连带赔偿责任<br>实际施工并造成损失的是乙公司，应由乙公司承担赔偿责任<br>因建设单位管理不到位，应由建设单位承担部分损失	B	《建筑法》规定，承包单位将承包的工程转包的，或者违反本法规定进行分包的，责令改正，没收违法所得，并处罚款，可以责令停业整顿，降低资质等级；情节严重的，吊销资质证书。承包单位有以上规定的违法行为的，对因转包工程或者违法分包的工程不符合规定的质量标准造成的损失，与接受转包或者分包的单位承担连带赔偿责任。
9. 某建设工程项目公开招标，甲公司借用乙公司资质证书承揽工程，获得中标，但甲承揽工程不符合质量标准给建设单位造成了损失。关于该合同关系的说法，正确的是{{c1::（）}}。[2014年真题]	甲、乙应承担连带赔偿责任<br>甲与乙属于联合体投标<br>实际施工并造成损失的是甲，与乙无关<br>投标人是乙，只能由乙承担赔偿责任	A	《建筑法》第六十六条规定，建筑施工企业转让、出借资质证书或者以其他方式允许他人以本企业的名义承揽工程的，责令改正，没收违法所得，并处罚款，可以责令停业整顿，降低资质等级；情节严重的，吊销资质证书。对因该项承揽工程不符合规定的质量标准造成的损失，建筑施工企业与使用本企业名义的单位或者个人承担连带赔偿责任。
10. 作为企业资质的法定条件，房屋建筑工程施工总承包二级企业的净资产应不少于{{c1::（）}}。	60000万元<br>5000万元<br>4000万元<br>800万元	C	《建筑业企业资质标准》规定，一级企业净资产1亿元以上；二级企业净资产4000万元以上；三级企业净资产800万元以上。
11. 如果以近5年承担过的施工总承包单体工程层高来衡量企业的业绩，符合二级企业资质法定条件的已完民用建筑工程单体层高最低为{{c1::（）}}。	6<br>12<br>25<br>30	B	在工程业绩方面，符合二级企业资质的法定条件为：近5年承担过下列4类中的2类工程的施工总承包或主体工程承包，工程质量合格。①地上12层以上的民用建筑工程1项或地上8～11层的民用建筑工程2项；②高度50米以上的构筑物工程1项或高度35～50米（不含）的构筑物工程2项；③建筑面积1万平方米以上的单体工业、民用建筑工程1项或建筑面积0.6万～1万平方米（不含）的单体工业、民用建筑工程2项；④钢筋混凝土结构单跨21米以上（或钢结构单跨24米以上）的建筑工程1项或钢筋混凝土结构单跨18～21米（不含）（或钢结构单跨21～24米（不含））的建筑工程2项。
12. 我国建筑业企业资质分为{{c1::（）}}三个序列。	工程总承包资质、施工总承包资质和专业承包资质<br>工程总承包资质、专业分包资质和施工劳务资质<br>施工总承包资质、专业分包资质和施工劳务资质<br>施工总承包资质、专业承包资质和施工劳务资质	D	《建筑业企业资质管理规定》第五条规定，建筑业企业资质分为施工总承包资质、专业承包资质、施工劳务资质三个序列。施工总承包资质、专业承包资质按照工程性质和技术特点分别划分为若干资质类别，各资质类别按照规定的条件划分为若干资质等级。施工劳务资质不分类别与等级。
13. 按照《建筑业企业资质管理规定》，下列关于施工企业资质类别的说法中，正确的是{{c1::（）}}。	施工总承包资质设有10个类别<br>专业承包资质设有60个资质类别<br>施工劳务资质设有13个类别<br>施工劳务资质不分类别和等级	D	《建筑业企业资质标准》规定，施工总承包资质序列设有12个类别；专业承包序列设有36个类别；施工劳务资质不分类别与等级。
14. 根据《建筑业企业资质管理规定》，关于我国建筑业企业资质的说法，错误的是{{c1::（）}}。	建筑业企业资质分为施工总承包资质、专业承包资质和施工劳务资质三个序列<br>施工劳务资质不分类别与等级<br>施工总承包资质、专业承包资质按照工程性质和技术特点分别划分为若干资质类别，各资质类别按照各自规定的条件划分为若干等级<br>房屋建筑工程施工总承包企业资质分为特级、一级、二级三个等级	D	ABC三项，《建筑业企业资质管理规定》第五条规定，建筑业企业资质分为施工总承包资质、专业承包资质、施工劳务资质三个序列。施工总承包资质、专业承包资质按照工程性质和技术特点分别划分为若干资质类别，各资质类别按照规定的条件划分为若干资质等级。施工劳务资质不分类别与等级。D项，房屋建筑工程施工总承包企业资质分为特级、一级、二级、三级四个等级。
15. 我国对建筑业企业的资质管理，实行{{c1::（）}}的管理模式。	权力下放<br>民主决策<br>权力上交<br>分级实施与有关部门相配合	D	我国对建筑业企业的资质管理，实行分级实施与有关部门相配合的管理模式。
16. 企业首次申请或增项申请资质的，应当申请{{c1::（）}}资质。	较高等级的<br>最低等级的<br>与自身能力相适应的<br>与承包的工程业绩相符的	B	《建筑业企业资质管理规定》中规定，建筑业企业可以申请一项或多项建筑业企业资质。企业首次申请或增项申请资质，应当申请最低等级资质。
17. 企业申请延续资质证书，应在资质证书有效期届满{{c1::（）}}前向发证机关提出申请。	6个月<br>3个月<br>1个月<br>15天	B	建筑业企业资质证书有效期为5年。建筑业企业资质证书有效期届满，企业继续从事建筑施工活动的，应当于资质证书有效期届满3个月前，向原资质许可机关提出延续申请。
18. 企业发生合并、分立、改制的，其资质证书{{c1::（）}}。	可承继<br>应当重新申请办理<br>应当申请重新核定资质等级<br>应向注册地主管部门申请变更	C	《建筑业企业资质管理规定》第二十一条规定，企业发生合并、分立、重组以及改制等事项，需承继原建筑业企业资质的，应当申请重新核定建筑业企业资质等级。
19. 因企业分立而新设立的建筑业企业，其资质等级应按{{c1::（）}}。	原企业的资质等级确定<br>降低一级原企业的资质等级确定<br>最低资质等级核定<br>实际达到的资质条件核定	D	《建筑业企业资质管理规定》第二十一条规定，企业发生合并、分立、重组以及改制等事项，需承继原建筑业企业资质的，应当申请重新核定建筑业企业资质等级。
20. 关于无资质的“实际施工人”利益受到侵害时处理的说法，正确的是{{c1::（）}}。	无资质承包主签订的劳务分包合同无效，其合同权益不受法律保护<br>实际施工人不能向没有合同关系的建设工程项目的发包方主张权利<br>实际施工人以发包人为被告主张权利时，则与转包人、违法分包人无关<br>建设工程项目发包人只在欠付工程价款的范围内对实际施工人承担责任	D	《最高人民法院关于审理建设工程施工合同纠纷案件适用法律问题的解释》第二十六条规定，实际施工人以转包人、违法分包人为被告起诉的，人民法院应当依法受理。实际施工人以发包人为被告主张权利的，人民法院可以追加转包人或者违法分包人为本案当事人。发包人只在欠付工程价款的范围内对实际施工人承担责任。
21. 根据我国《建筑法》的规定，资质不同的单位组成的承包联合体，应当{{c1::（）}}。	按照资质等级高的单位业务许可范围承揽该工程<br>按照资质等级低的单位业务许可范围承揽该工程<br>按照联合体内部协商的资质等级承揽该工程<br>按照发包单位确定的单位资质等级承揽该工程	B	《建筑法》第二十七条第二款规定，两个以上不同资质等级的单位实行联合共同承包的，应当按照资质等级低的单位的业务许可范围承揽工程。
22. 建设单位将工程发包给不具有相应资质条件的施工企业，或者违反规定将建筑工程肢解发包的，责令改正，处以{{c1::（）}}。	吊销资质证书<br>罚款<br>停业整顿<br>降低资质等级	B	《建筑法》第六十五条规定，发包单位将工程发包给不具有相应资质条件的承包单位的，或者违反本法规定将建筑工程肢解发包的，责令改正，处以罚款。未取得资质证书承揽工程的，予以取缔，并处罚款；有违法所得的，予以没收。
23. 关于分包工程发生质量、安全、进度等问题给建设单位造成损失的责任承担的说法，正确的是{{c1::（）}}。	建设单位只能向给其造成损失的分包单位主张权利<br>建设单位与分包单位无合同关系，无权向分包单位主张权利<br>总承包单位承担的责任超过其应承担份额的，有权向分包单位追偿<br>分包单位只对总承包单位负责	C	AB两项，建设单位既可以根据总承包合同向总承包单位追究违约责任，也可以根据法律规定直接要求分包单位承担损害赔偿责任，分包单位不得拒绝；D项，分包单位向总承包单位与建设单位负责。
24. 关于施工企业承揽工程的说法，正确的是{{c1::（）}}。	施工企业可以允许其他企业使用自己的资质证书和营业执照<br>施工企业应当拒绝其他企业转让资质证书<br>施工企业在施工现场所设项目管理机构的项目负责人可以不是本单位人员<br>施工企业由于不具备相应资质等级只能以其他企业名义承揽工程	B	AB两项，《建筑法》第六十六条规定，建筑施工企业转让、出借资质证书或者以其他方式允许他人以本企业的名义承揽工程的，责令改正，没收违法所得，并处罚款，可以责令停业整顿，降低资质等级；情节严重的，吊销资质证书。C项，《房屋建筑和市政基础设施工程施工分包管理办法》规定，分包工程发包人没有将其承包的工程进行分包，在施工现场所设项目管理机构的项目负责人、技术负责人、项目核算负责人、质量管理人员、安全管理人员不是工程承包人本单位人员的，视同允许他人以本企业名义承揽工程。D项，该《管理办法》规定，分包工程承包人必须具有相应的资质，并在其资质等级许可的范围内承揽业务。
