1. 根据GB/T 24001（中国环境管理体系）—ISO 14001标准的应用原则，在组织的管理体系中，环境管理体系{{c1::（）}}。［2009年真题］	应在组织整个管理体系之外独立存在<br>不必成为独立的管理系统，应纳入组织整个管理体系中<br>应融入组织的质量和职业健康安全管理体系中<br>应在组织的整个管理体系之上，作为其他管理体系的基础	B	环境管理体系标准的应用原则有：①标准的实施强调自愿性原则，并不改变组织的法律责任；②有效的环境管理需建立并实施结构化的管理体系；③标准着眼于采用系统的管理措施；④环境管理体系不必成为独立的管理系统，而应纳入组织整个管理体系中；⑤实施环境管理体系标准的关键是坚持持续改进和环境污染预防；⑥有效地实施环境管理体系标准，必须有组织最高管理者的承诺和责任以及全员的参与。
2. 施工企业实施环境管理体系标准的关键是{{c1::（）}}。［2013年真题］	坚持持续改进和环境污染预防<br>采用PDCA循环管理模式<br>组织最高管理者的承诺<br>组织全体员工的参与	A	环境管理体系标准的应用原则有：①标准的实施强调自愿性原则，并不改变组织的法律责任；②有效的环境管理需建立并实施结构化的管理体系；③标准着眼于采用系统的管理措施；④环境管理体系不必成为独立的管理系统，而应纳入组织整个管理体系中；⑤实施环境管理体系标准的关键是坚持持续改进和环境污染预防；⑥有效地实施环境管理体系标准，必须有组织最高管理者的承诺和责任以及全员的参与。
3. 施工企业职业健康安全管理体系的纲领性文件是{{c1::（）}}。[2015年真题]	作业文件<br>管理手册<br>程序文件<br>监测活动准则	B	职业健康安全管理体系文件包括管理手册、程序文件、作业文件三个层次。体系文件的编写应遵循“标准要求的要写到、文件写到的要做到、做到的要有有效记录”的原则。其中，管理手册是对施工企业整个管理体系的整体性描述，为体系的进一步展开以及后续程序文件的制定提供了框架要求和原则规定，是管理体系的纲领性文件。
4. 施工企业职业健康安全管理体系的运行及维持活动中，应由{{c1::（）}}对管理体系进行系统评价。[2015年真题]	施工企业技术负责人<br>施工企业安全部门负责人<br>项目经理<br>施工企业的最高管理者	D	管理评审是由施工企业的最高管理者对管理体系的系统评价，判断企业的管理体系面对内部情况的变化和外部环境是否充分适应有效，由此决定是否对管理体系做出调整，包括方针、目标、机构和程序等。
5. 及时购买补充适用的规范、规程等行业标准的活动，属于职业健康安全体系运行中的{{c1::（）}}活动。[2014年真题]	信息交流<br>执行控制程序<br>文件管理<br>预防措施	C	体系运行是指按照已建立体系的要求实施，其实施的重点是围绕培训意识和能力，信息交流，文件管理，执行控制程序，监测，不符合、纠正和预防措施，记录等活动推进体系的运行工作。其中，文件管理包括对现有有效文件进行整理编号，方便查询索引；对适用的规范、规程等行业标准应及时购买补充，对适用的表格要及时发放；对在内容上有抵触的文件和过期的文件要及时作废并妥善处理。
6. 职业健康安全管理体系标准的结构系统，采用PDCA动态循环、不断上升的螺旋式运行模式，这体现了{{c1::（）}}的动态管理思想。	持续改进<br>全过程控制<br>预防为主<br>系统管理	A	职业健康安全管理体系标准的结构系统采用PDCA循环管理模式，即标准由“职业健康安全方针—策划—实施与运行—检查和纠正措施—管理评审”五大要素构成，采用了PDCA动态循环、不断上升的螺旋式运行模式，体现了持续改进的动态管理思想。
7. 关于职业健康安全管理体系标准建立和运行过程的特点，下列说法有误的是{{c1::（）}}。	标准强调了职业健康安全法规和制度的贯彻执行，要求组织必须对遵守法律、法规做出承诺，并定期进行评审以判断其遵守的实效<br>标准强调了职业健康安全法规和制度的贯彻执行，要求组织必须对遵守法律、法规做出承诺，并每周进行评审以判断其遵守的实效<br>标准的内容全面、充实、可操作性强<br>实施职业健康安全管理体系标准，组织必须对全体员工进行系统的安全培训	B	B项，标准强调了职业健康安全法规和制度的贯彻执行，要求组织必须对遵守法律、法规做出承诺，并定期进行评审以判断其遵守的实效。
8. 国际标准化组织制定推出ISO 14000环境管理系列标准后，我国将其等同转换为国家标准{{c1::（）}}系列标准。	GB14000<br>GB/T14000<br>GB24000<br>GB/T24000	D	2005年5月10日我国颁布了新的《环境管理体系》GB／T 24000国家标准体系，代替了1996年版的《环境管理体系》GB／T 24000，并于2005年5月15日实施，其主要包括：GB／T 24001—2004《环境管理体系要求及使用指南》；GB／T 24004—2004《环境管理体系原则、体系和支持技术通用指南》。国际标准化组织制定的ISO 14000体系标准，被我国等同采用。
9. 下列属于《环境管理体系标准》（ISO 14000）的总目的的是{{c1::（）}}。	辨别组织内部存在的危险源，控制其所带来的危险，从而避免或减少事故的发生<br>确保工程施工者的人身和财产安全<br>支持环境保护和污染预防，协调它们与社会需求和经济需求的关系，指导各类组织取得并表现出良好的环境行为<br>保证施工的质量不受施工现场环境的影响	C	国际标准化组织制定的ISO 14000体系标准，被我国等同采用。《环境管理体系标准》（ISO 14000）总的目的是支持环境保护和污染预防，协调它们与社会需求和经济需求的关系，指导各类组织取得并表现出良好的环境行为。
10. 《环境管理体系要求及使用指南》GB/T 24001—2004的总体结构中，策划的基本要求和内容是{{c1::（）}}。	环境因素，法律法规和其他要求，目标、指标和方案<br>最高管理者应确定本组织的环境方针<br>资源、作用、职责和权限，能力、培训和意识，信息交流等<br>监测和测量，合规性评价，记录控制等	A	B项为环境方针的基本要求和内容；C项为实施与运行的基本要求和内容之一；D项为检查的基本要求和内容之一。
11. 对于建设工程项目，施工环境保护主要是指{{c1::（）}}。	减少对施工环境的污染<br>制定环境保护的标准方案<br>阻止和降低破坏环境的风险源<br>保护和改善施工现场的环境	D	对于建设工程项目，施工环境保护主要是指保护和改善施工现场的环境。企业应当遵照国家和地方的相关法律法规以及行业和企业自身的要求，采取措施控制施工现场的各种粉尘、废水、废气、固体废弃物以及噪声、振动对环境的污染和危害，并且要注意对资源的节约和避免资源的浪费。
12. 建设工程项目的建设周期长，诸多环节、工序环环相扣，前一道工序的隐患，可能在后续的工序中暴露，据此开展施工职业健康安全和环境管理活动，反映的是职业健康安全与环境管理的{{c1::（）}}。	协调性<br>持续性<br>复杂性<br>多样性	B	施工职业健康安全与环境管理有持续性的特点，表现为：项目建设一般具有建设周期长的特点，从前期决策、设计、施工直至竣工投产，诸多环节、工序环环相扣。前一道工序的隐患，可能在后续的工序中暴露，酿成安全事故。
13. 施工企业在施工项目生产的活动中，必须对安全生产负全面责任，安全生产的第一负责人是{{c1::（）}}。	项目经理<br>项目专职安全管理员<br>企业的法定代表人<br>企业总工程师	C	施工企业在其经营生产的活动中必须对本企业的安全生产负全面责任。企业的法定代表人是安全生产的第一负责人，项目经理是施工项目生产的主要负责人。
14. 下列各项不属于建设工程对施工职业健康安全管理的基本要求是{{c1::（）}}。	坚持安全第一、预防为主、防治结合<br>对本企业的安全生产负全面责任<br>采用环保的建筑设计方案<br>制定职业健康安全生产技术措施计划	C	根据《建设工程安全生产管理条例》和《职业健康安全管理体系》GB/T 28000标准，建设工程对施工职业健康安全管理的基本要求包括：①坚持安全第一、预防为主和防治结合的方针，建立职业健康安全管理体系并持续改进职业健康安全管理工作。②施工企业在其经营生产的活动中必须对本企业的安全生产负全面责任。③在工程设计阶段，设计单位应按照有关建设工程法律法规的规定和强制性标准的要求，进行安全保护设施的设计。④在工程施工阶段，施工企业应根据风险预防要求和项目的特点，制定职业健康安全生产技术措施计划。⑤应明确和落实工程安全环保设施费用、安全施工和环境保护措施费等各项费用。⑥施工企业应按有关规定必须为从事危险作业的人员在现场工作期间办理意外伤害保险。⑦现场应将生产区与生活、办公区分离，配备紧急处理医疗设施，使现场的生活设施符合卫生防疫要求，采取防暑、降温、保温、消毒、防毒等措施。
15. 关于工程施工阶段施工环境管理基本要求的说法，正确的是{{c1::（）}}。	建设工程中防治污染的设施，应紧随主体工程设计之后进行设计并施工<br>建设工程应当采用节能、节水等有利于资源保护的建筑设计方案<br>建设工程的施工对周围环境不得产生噪声<br>污染防治措施应确保污染物排放达到企业的排放标准，满足总量控制要求	B	A项，建设工程项目中防治污染的设施，必须与主体工程同时设计、同时施工、同时投产使用；C项，尽量减少建设工程施工所产生的噪声对周围生活环境的影响；D项，拟采取的污染防治措施应确保污染物排放达到国家和地方规定的排放标准，满足污染物总量控制要求。
16. 具有防治污染设施的建设工程项目可投入生产或者使用的条件是，防治污染的设施必须经{{c1::（）}}验收合格。	项目所在地的建设主管部门<br>项目投资人所在地的环境保护行政主管部门<br>审批设计文件的建设主管部门<br>原审批环境影响报告书的环境保护行政主管部门	D	建设工程项目中防治污染的设施，必须与主体工程同时设计、同时施工、同时投产使用。防治污染的设施必须经原审批环境影响报告书的环境保护行政主管部门验收合格后，该建设工程项目方可投入生产或者使用。
17. 职业健康安全管理体系建立的主要工作有：①制定方针、目标、指标和管理方案；②初始状态评审；③文件的审查、审批和发布；④体系文件编写；⑤管理体系策划与设计等，正确的工作步骤顺序是{{c1::（）}}。	①—②—⑤—④—③<br>②—①—④—③—⑤<br>②—①—⑤—④—③<br>①—⑤—②—④—③	C	职业健康安全管理体系与环境管理体系的建立应当遵循以下步骤：①领导决策；②成立工作组；③人员培训；④初始状态评审；⑤制定方针、目标、指标和管理方案；⑥管理体系策划与设计；⑦体系文件编写；⑧文件的审查、审批和发布。
18. 关于职业健康安全管理体系与环境管理体系文件，下列说法有误的是{{c1::（）}}。	体系文件的编写应遵循“标准要求的要写到、文件写到的要做到、做到的要有有效记录”的原则<br>作业文件是管理体系的纲领性文件<br>程序文件的内容可按“4W1H”的顺序和内容来编写<br>文件编写完成后应进行审查，经审查、修改、汇总后进行审批，然后发布	B	B项，管理手册是对施工企业整个管理体系的整体性描述，为体系的进一步展开以及后续程序文件的制定提供了框架要求和原则规定，是管理体系的纲领性文件。
19. 下列施工职业健康安全管理体系的运行工作中，不属于实施重点的是{{c1::（）}}。	自我学习<br>执行控制程序<br>监测<br>不符合、纠正和预防措施	A	体系运行是指按照已建立体系的要求实施，其实施的重点是围绕培训意识和能力，信息交流，文件管理，执行控制程序，监测，不符合、纠正和预防措施，记录等活动推进体系的运行工作。
20. 为确保职业健康安全管理体系和环境管理体系的持续适宜性、充分性和有效性，对组织的管理体系进行评审的应是施工企业的{{c1::（）}}。	安全总监<br>项目经理<br>技术总监<br>最高管理者	D	管理评审是由施工企业的最高管理者对管理体系的系统评价，判断企业的管理体系面对内部情况的变化和外部环境是否充分适应有效，由此决定是否对管理体系做出调整，包括方针、目标、机构和程序等。
21. 关于施工职业健康安全管理体系合规性评价次数的说法，正确的是{{c1::（）}}。	项目组级合规性评价每年进行两次<br>项目组级合规性评价每年进行一次<br>公司级合规性评价每年进行两次<br>公司级合规性评价每年进行一次	D	为了履行对合规性承诺，合规性评价分公司级和项目组级评价两个层次进行。<br/>项目组级评价，由项目经理组织有关人员对施工中应遵守的法律法规和其他要求的执行情况进行一次合规性评价。当某个阶段施工时间超过半年时，合规性评价不少于一次。项目工程结束时应针对整个项目工程进行系统的合规性评价。公司级评价每年进行一次，制定计划后由管理者代表组织企业相关部门和项目组，对公司应遵守的法律法规和其他要求的执行情况进行合规性评价。
