1. 关于投标文件撤回和撤销的说法，正确的是{{c1::（）}}。[2017年真题]	投标人可以选择电话或书面方式通知招标人撤回投标文件<br>招标人收取的投标保证金，应当自收到投标人撤回通知之日起10日内退还<br>投标截止时间后投标人撤销投标文件的，招标人应当退还投标保证金<br>投标人撤回已提交的投标文件，应当在投标截止时间前通知招标人	D	A项，撤回投标文件必须以书面方式提交申请；B项，投标人撤回已提交的投标文件，招标人已收取投标保证金的，应当自收到投标人书面撤回通知之日起5日内退还；C项，投标截止日后撤回投标文件，招标人可不退还投标保证金。
2. 2016年9月15日，甲材料供应商与丙材料供应商订立书面合同，转让甲对乙施工企业的30万元债权。同年9月25日，乙接到甲关于转让债权的通知。关于该债权转让的说法，正确的是{{c1::（）}}。[2017年真题]	甲与丙之间的债权转让合同9月25日生效<br>丙于9月15日可以向乙主张30万元债权<br>甲与丙之间的债权转让行为于9月25日对乙生效<br>乙拒绝清偿30万元债务的，丙可以要求甲和乙承担连带责任	C	债权人转让权利的，应当通知债务人。未经通知，该转让对债务人不发生效力。但债权人债权的转让无需得到债务人的同意。这一方面是尊重债权人对其权利的行使，另一方面也防止债权人滥用权利损害债务人的利益。当债务人接到权利转让的通知后，权利转让即行生效，原债权人被新的债权人替代，或者新债权人的加入使原债权人不再完全享有原债权。2016年9月25日乙接到甲关于转让债权的通知，甲与丙之间的债权转让行为于9月25日对乙生效。
3. 甲建设单位与乙设计单位签订设计合同，约定设计费用200万元，甲按约定向乙支付了定金50万元。如果乙在规定期限内不履行设计合同，应该返还给甲{{c1::（）}}。[2017年真题]	50万元<br>80万元<br>90万元<br>100万元	C	《担保法》规定，当事人可以约定一方向对方给付定金作为债权的担保。债务人履行债务后，定金应当抵作价款或者收回。给付定金的一方不履行约定的债务的，无权要求返还定金；收受定金的一方不履行约定的债务的，应当双倍返还定金。定金的数额由当事人约定，但不得超过主合同标的额的20%。本题中，定金的最高额为200×20%＝40（万元），乙在规定期限内不履行设计合同，应双倍返还定金。此外，甲按约定向乙支付的50万元定金中，超出定金最高额的10万元也应返还给甲建设单位。所以，如果乙在规定期限内不履行设计合同，应该返还给甲：200×20%×2＋（50－200×20%）＝90（万元）。
4. 关于担保的说法，正确的是{{c1::（）}}。[2015年真题]	担保是用益物权的一种<br>担保的目的是保障特定债权的实现<br>担保合同是主合同<br>反担保不适用《担保法》的规定	B	A项，担保是担保物权，而非用益物权。B项，担保是指当事人根据法律规定或者双方约定，为促使债务人履行债务实现债权人的权利的法律制度。C项，担保合同是主合同的从合同，主合同无效，担保合同无效。D项，第三人为债务人向债权人提供担保时，可以要求债务人提供反担保。反担保适用《担保法》担保的规定。
5. 主债权债务合同无效，担保合同{{c1::（）}}，但法律另有规定的除外。［2010年真题］	仍然有效<br>无效<br>在担保期间内有效<br>效力待定	B	《担保法》第五条规定，担保合同是主合同的从合同，主合同无效，担保合同无效。担保合同另有约定的，按照约定。担保合同被确认无效后，债务人、担保人、债权人有过错的，应当根据其过错各自承担相应的民事责任。
6. 一般保证的保证人与债权人未约定保证期间的，保证期间为主债务履行期届满之日起{{c1::（）}}。［2012年真题］	3个月<br>6个月<br>1年<br>2年	B	一般保证的保证人未约定保证期间的，保证期间为主债务履行期届满之日起6个月。连带责任保证的保证人与债权人未约定保证期间的，债权人有权自主债务履行期届满之日起6个月内要求保证人承担保证责任。
7. 关于抵押的说法，正确的是{{c1::（）}}。[2016年真题]	当事人可以在抵押合同中约定抵押担保的范围<br>抵押人没有义务妥善保管抵押物并保证其价值不变<br>转让抵押物的价款只需高于担保债权即可<br>抵押权可以与其担保的债权分离而单独转让	A	A项，根据《物权法》第一百七十三条规定，担保物权的担保范围包括主债权及其利息、违约金、损害赔偿金、保管担保财产和实现担保物权的费用。当事人另有约定的，按照约定。B项，抵押人有义务妥善保管抵押物并保证其价值。C项，抵押期间，抵押人未经抵押权人同意，不得转让抵押财产，但受让人代为清偿债务消灭抵押权的除外。D项，抵押权与其担保的债权同时存在。抵押权不得与债权分离而单独转让或者作为其他债权的担保。
8. 某开发商其A地块的建设用地使用权作为向银行贷款的担保，确保按期还贷，此担保方式属于{{c1::（）}}。[2015年真题]	保证<br>质押<br>抵押<br>留置	C	A项，保证是指保证人和债权人约定，当债务人不履行债务时，保证人按照约定履行债务或者承担责任的行为。B项，质押是指债务人或者第三人将其动产或权利移交债权人占有，将该动产或权利作为债权的担保。C项，抵押是指债务人或者第三人不转移对财产的占有，将该财产作为债权的担保。债务人不履行债务时，债权人有权依照法律规定以该财产折价或者以拍卖、变卖该财产的价款优先受偿。债务人或者第三人有权处分的下列财产可以抵押：①建筑物和其他土地附着物；②建设用地使用权；③以招标、拍卖、公开协商等方式取得的荒地等土地承包经营权；④生产设备、原材料、半成品、产品；⑤正在建造的建筑物、船舶、航空器；⑥交通运输工具；⑦法律、行政法规未禁止抵押的其他财产。D项，留置是指债权人按照合同约定占有债务人的动产，债务人不按照合同约定期限履行债务的，债权人有权按照法律规定留置该财产，以该财产折价或者拍卖、变卖该财产的价款优先受偿。
9. 根据《担保法》，下列财产不能作为担保物的是{{c1::（）}}。[2014年真题]	厂房<br>可转让的专利权<br>生产原材料<br>公立幼儿园的教育设施	D	下列财产不得抵押：①土地所有权；②耕地、宅基地、自留地、自留山等集体所有的土地使用权；③学校、幼儿园、医院等以公益为目的的事业单位、社会团体的教育设施、医疗卫生设施和其他社会公益设施；④所有权、使用权不明或者有争议的财产；⑤依法被查封、扣押、监管的财产；⑥依法不得抵押的其他财产。
10. 根据《物权法》的相关规定，以建筑物抵押的，抵押权自{{c1::（）}}时设立。［2010年真题］	合同签订<br>备案<br>交付<br>登记	D	《物权法》规定，当事人以下列财产抵押的，应当办理抵押登记，抵押权自登记时设立：①建筑物和其他土地附着物；②建设用地使用权；③以招标、拍卖、公开协商等方式取得的荒地等土地承包经营权；④正在建造的建筑物。
11. 根据《物权法》，下列不适合作为质押财产的是{{c1::（）}}。［2011年真题］	汇票<br>仓单<br>建设用地<br>应收账款	C	按照《担保法》、《物权法》的规定，质押是指债务人或者第三人将其动产或权利移交债权人占有，将该动产或权利作为债权的担保。债务人不履行债务时，债权人有权依照法律规定以该动产或权利折价或者以拍卖、变卖该动产或权利的价款优先受偿。建设用地属于不动产，所以不适合作为质押财产。
12. 在下列担保方式中，只能由债务人而非第三人提供担保的是{{c1::（）}}。［2013年真题］	抵押<br>保证<br>质押<br>留置	D	按照《担保法》、《物权法》的规定，留置是指债权人按照合同约定占有债务人的动产，债务人不按照合同约定的期限履行债务的，债权人有权依照法律规定留置该财产，以该财产折价或者以拍卖、变卖该财产的价款优先受偿。
13. 关于留置的说法，正确的是{{c1::（）}}。［2012年真题］	留置的标的是不动产<br>不转移对物的占有是留置与质押的显著区别<br>留置权人负有妥善保管留置财产的义务<br>置物留置期间债权人不能与债务人协议处理留置物	C	按照《担保法》、《物权法》的规定，留置是指债权人按照合同约定占有债务人的动产，债务人不按照合同约定的期限履行债务的，债权人有权依照法律规定留置该财产，以该财产折价或者以拍卖、变卖该财产的价款优先受偿。留置权人负有妥善保管留置物的义务。因保管不善致使留置物灭失或者毁损的，留置权人应当承担民事责任。
14. 关于定金的说法，正确的是{{c1::（）}}。[2016年真题]	债务人履行债务后，定金不可抵作价款<br>订金与定金的法律效果相同<br>定金超过合同金额的20%，则定金无效<br>定金的法律性质是担保	D	AD两项，根据《担保法》第八十九条规定，当事人可以约定一方向对方给付定金作为债权的担保。债务人履行债务后，定金应当抵作价款或者收回。给付定金的一方不履行约定的债务的，无权要求返还定金；收受定金的一方不履行约定的债务的，应当双倍返还定金。B项，订金与定金的法律效果不同，前者不具有法律效力，后者具有法律效力。C项，根据《担保法》第九十一条规定，定金的数额由当事人约定，但不得超过主合同标的额的20%。根据《最高人民法院关于适用〈中华人民共和国担保法〉若干问题的解释》第一百二十一条规定，当事人约定的定金数额超过主合同标的额20%的，超过的部分，人民法院不予支持。据此，定金超过合同金额的20%，超过的部分无效，未超过的部分仍然有效。
15. 按照《担保法》的规定，可以作为保证人的是{{c1::（）}}。	厂矿的职能部门<br>有限责任公司<br>政府机关<br>某高等学校	B	根据《担保法》第八条至第十条的规定，下列单位不可以作保证人：①国家机关不得为保证人，但经国务院批准为使用外国政府或者国际经济组织贷款进行转贷的除外；②学校、幼儿园、医院等以公益为目的的事业单位、社会团体不得为保证人；③企业法人的分支机构、职能部门不得为保证人。但企业法人的分支机构有法人书面授权的，可以在授权范围内提供保证。
16. 甲企业向乙银行借款100万元，由丙企业作为保证人。合同签订3个月后，甲与乙协商，将贷款金额增加到150万元，甲和乙通知了丙，丙未予答复。后甲到期不能偿还债务。关于该案中的保证责任承担的说法，正确的是{{c1::（）}}。	丙应承担150万元的保证责任，因为丙对甲和乙的通知未予答复，视为默认<br>丙不再承担保证责任，因为甲与乙变更合同条款未得到丙的同意<br>丙不再承担保证责任，保证合同因甲、乙变更了合同的金额条款而无效<br>丙对100万元应承担保证责任，对于增加的50万元不承担保证责任	D	《最高人民法院关于适用〈中华人民共和国担保法〉若干问题的解释》第三十条规定，保证期间，债权人与债务人对主合同数量、价款、币种、利率等内容作了变动，未经保证人同意的，如果减轻债务人的债务的，保证人仍应当对变更后的合同承担保证责任；如果加重债务人的债务的，保证人对加重的部分不承担保证责任。
17. 甲、乙双方签订买卖合同，丙为乙的债务提供保证，但保证合同中未约定保证方式及保证期间，下列说法正确的是{{c1::（）}}。	丙的保证方式为一般保证<br>保证期间与买卖合同的诉讼时效相同<br>如果甲在保证期间内未要求丙承担保证责任，则丙免除保证责任<br>如果甲在保证期间内未经丙书面同意将主债权转让给丁，则丙不再承担保证责任	C	A项，《担保法》第十九条规定，当事人对保证方式没有约定或者约定不明确的，按照连带责任保证承担保证责任；BC两项，第二十六条规定，连带责任保证的保证人与债权人未约定保证期间的，债权人有权自主债务履行期届满之日起6个月内要求保证人承担保证责任。在合同约定的保证期间和前款规定的保证期间，债权人未要求保证人承担保证责任的，保证人免除保证责任；D项，第二十二条规定，保证期间，债权人依法将主债权转让给第三人的，保证人在原保证担保的范围内继续承担保证责任。保证合同另有约定的，按照约定。
18. 按照《担保法》的规定，债权人依法将主债权转让给第三人，在通知债务人和保证人后，保证人{{c1::（）}}。	可以在减少保证范围的前提下再承担保证责任<br>必须在原担保范围内继续承担保证责任<br>可以拒绝再承担保证责任<br>同意后，才继续承担保证责任	B	《担保法》第二十二条规定，保证期间，债权人依法将主债权转让给第三人的，保证人在原保证担保的范围内继续承担保证责任。保证合同另有约定的，按照约定。
19. 保证合同是{{c1::（）}}订立的合同。	债权人与债务人<br>债务人和保证人<br>债权人与保证人<br>债权人与债务人和保证人	C	保证人与债权人应当以书面形式订立保证合同。保证人与债权人可以就单个主合同分别订立保证合同，也可以协议在最高债权额限度内就一定期间连续发生的借款合同或者某项商品交易合同订立一个保证合同。
20. 某贷款合同，借款方以一块林地的承包经营权向贷款方做了抵押担保，但未到县级林业主管部门办理抵押登记，贷方即拨付了借贷的资金。按照相关法律规定，该抵押合同{{c1::（）}}。	在贷款方将资金拨付至借款方账户时生效<br>由于事先未获得林业主管部门的批准，属于无效合同<br>自当事人双方签字盖章后即生效<br>自借贷双方办理完抵押登记手续后生效	C	根据《物权法》第十五条的规定，当事人之间订立有关设立、变更、转让和消灭不动产物权的合同，除法律另有规定或者合同另有约定外，自合同成立时生效；未办理物权登记的，不影响合同效力。本案中签订的抵押合同应当自当事人双方签字盖章后即生效。
21. 根据我国担保法律制度，关于抵押权实现的说法，错误的是{{c1::（）}}。	债务履行期届满抵押权人未受清偿的，可以与抵押人协议以拍卖该抵押物所得价款受偿<br>同一财产向两个以上债权人抵押，抵押合同以登记生效的，按抵押登记的先后顺序清偿<br>同一财产向两个以上债权人抵押，抵押合同自签订之日起生效的，若抵押物未登记的，按照合同生效的先后顺序清偿<br>抵押物折价后，其价款超过债权数额的部分归债务人所有，不足部分由债务人清偿	D	A项，债务履行期届满抵押权人未受清偿的，可以与抵押人协议以抵押物折价或者以拍卖、变卖该抵押物所得的价款受偿；协议不成的，抵押权人可以向人民法院提起诉讼。BC两项，同一财产向两个以上债权人抵押的，拍卖、变卖抵押物所得的价款按照以下规定清偿：①抵押合同以登记生效的，按抵押物登记的先后顺序清偿；顺序相同的，按照债权比例清偿。②抵押合同自签订之日起生效的，如果抵押物未登记的，按照合同生效的先后顺序清偿，顺序相同的，按照债权比例清偿。抵押物已登记的先于未登记的受偿。D项，抵押物折价或者拍卖、变卖后，其价款超过债权数额的部分归抵押人所有，不足部分由债务人清偿。
22. 施工企业购买材料设备后交付承运人运输，未按约定给付承运费用时，承运人有权扣留足以清偿其所欠运费的货物，承运人行使的是{{c1::（）}}。	抵押权<br>质权<br>留置权<br>所有权	C	《物权法》第二百三十条规定，债务人不履行到期债务，债权人可以留置已经合法占有的债务人的动产，并有权就该动产优先受偿。前款规定的债权人为留置权人，占有的动产为留置财产。
23. 根据《物权法》，下列各项财产作为抵押物时，抵押权自登记时设立的是{{c1::（）}}。	正在建造的建筑物<br>生产设备、原材料<br>交通运输工具<br>正在建造的船舶、航空器	A	当事人以下列财产抵押的，应当办理抵押登记，抵押权自登记时设立：①建筑物和其他土地附着物；②建设用地使用权；③以招标、拍卖、公开协商等方式取得的荒地等土地承包经营权；④正在建造的建筑物。当事人以下列财产抵押的，抵押权自抵押合同生效时设立，未经登记，不得对抗善意第三人：①生产设备、原材料、半成品、产品；②交通运输工具；③正在建造的船舶、航空器。
24. 甲乙双方签订总价为100万元的合同，并设定定金条款，则定金的最高限额应为{{c1::（）}}万元。	10<br>30<br>50<br>20	D	《担保法》规定，定金应当以书面形式约定。当事人在定金合同中应当约定交付定金的期限。定金合同从实际交付定金之日起生效。定金的数额由当事人约定，但不得超过主合同标的额的20%。
