1. 某工程因施工需要，需取得出入施工场地的临时道路的通行权，根据《标准施工招标文件》，该通行权应当由{{c1::（）}}。[2015年真题]	承包人负责办理，并承担有关费用<br>承包人负责办理，发包人承担有关费用<br>发包人负责办理，并承担有关费用<br>发包人负责办理，承包人承担有关费用	C	除专用合同条款另有约定外，发包人应根据合同工程的施工需要，负责办理取得出入施工场地的专用和临时道路的通行权，以及取得为工程建设所需修建场外设施的权利，并承担有关费用。承包人应协助发包人办理上述手续。
2. 根据《标准施工招标文件》，现场地质勘探资料、水文气象资料的准确性应由{{c1::（）}}负责。[2011年真题]	地质勘查单位<br>发包人<br>承包人<br>监理人	B	发包人应将其持有的现场地质勘探资料、水文气象资料提供给承包人，并对其准确性负责。但承包人应对其阅读上述有关资料后所作出的解释和推断负责。
3. 根据《标准施工招标文件》，关于发包人责任和义务的说法，错误的是{{c1::（）}}。[2014年真题]	按通专用合同条款约定提供施工场地<br>提供施工场地内地下管线和地下设施等资料，并保证资料的真实、准确、完整<br>负责办理法律规定的有关施工证件和批件<br>负责赔偿工程或工程的任何部分对土地的占用所造成的第三者财产损失	C	根据《标准施工招标文件》，发包人的义务包括：①遵守法律。发包人在履行合同过程中应遵守法律，并保证承包人免于承担因发包人违反法律而引起的任何责任。②发出开工通知。发包人应委托监理人按合同约定向承包人发出开工通知。③提供施工场地。发包人应按专用合同条款约定向承包人提供施工场地，以及施工场地内地下管线和地下设施等有关资料，并保证资料的真实、准确、完整。④协助承包人办理证件和批件发包人应协助承包人办理法律规定的有关施工证件和批件。⑤组织设计交底。发包人应根据合同进度计划，组织设计单位向承包人进行设计交底。⑥支付合同价款发包人应按合同约定向承包人及时支付合同价款。⑦组织竣工验收发包人应按合同约定及时组织竣工验收。⑧其他义务发包人应履行合同约定的其他义务。
4. 承包人按照监理人批准的进度计划组织施工，但由于进度计划本身存在缺陷造成工期延误，则责任应由{{c1::（）}}承担。[2010年真题]	发包人<br>承包人<br>监理人<br>分包人	B	承包人应按合同约定的工作内容和施工进度要求，编制施工组织设计和施工措施计划，并对所有施工作业和施工方法的完备性和安全可靠性负责。监理人的批准确认不免除承包人的责任。
5. 根据《标准施工招标文件》，关于暂停施工的说法，正确的是{{c1::（）}}。[2014年真题]	由于发包人原因引起的暂停施工，承包人有权要求延长工期和（或）增加费用，但不得要求补偿利润<br>发包人原因造成暂停施工，承包人可不负责暂停施工期间工程的保护<br>因发包人原因发生暂停施工的紧急情况时，承包人可以先暂停施工，并及时向监理人提出暂停施工的书面请求<br>施工中出现一些意外需要暂停施工的，所有责任由发包人承担	C	A项，发包人原因引起的暂停施工，承包人可以要求工期、费用和利润的索赔；B项，发包人原因造成暂停施工，承包人负责暂停施工期间工程的保护；D项，并不是所有的暂停施工，发包人都要承担所有责任。
6. 根据《标准施工招标文件》，承包人按照合同规定将隐蔽工程覆盖后，监理人要求承包人对已覆盖部位揭开重新检测，经检验证明工程质量符合要求，由此增加的费用和延误的工期应由{{c1::（）}}承担。[2011年真题]	发包人<br>承包人<br>监理人<br>设计单位	A	《建设工程施工合同示范文本》规定，承包人按照合同规定覆盖工程隐蔽部位后，监理人对质量有疑问的，可要求承包人对已覆盖的部位进行钻孔探测或揭开重新检验，承包人应遵照执行，并在检验后重新覆盖恢复原状。经检验证明工程质量符合合同要求的，由发包人承担由此增加的费用和（或）工期延误，并支付承包人合理利润；经检验证明工程质量不符合合同要求的，由此增加的费用和（或）工期延误由承包人承担。
7. 某工程施工过程中，承包人未通知监理人检査，私自对某隐蔽部位进行了覆盖，监理人指示承包人揭开检査，经检査该隐蔽部位质量符合合同要求。根据《标准施工招标文件》，由此增加的费用和（或）工期延误应由{{c1::（）}}承担。[2015年真题]	发包人<br>监理人<br>承包人<br>分包人	C	承包人未通知监理人到场检查，私自将工程隐蔽部位覆盖的，监理人有权指示承包人钻孔探测或揭开检查，由此增加的费用和（或）工期延误由承包人承担。
8. 现场监理工程师检查发现业主指定分包人施工的防水工程存在质量问题，对此质量问题发出整改指令的正确做法是{{c1::（）}}。[2009年真题]	业主向分包人发出质量问题整改通知单<br>监理方向分包人发出质量问题联系单<br>监理方向总承包人发出监理通知单<br>监理方向业主发出监理工作联系单	C	施工总承包方是工程施工的总执行者和总组织者，它除了完成自己承担的施工任务以外，还负责组织和指挥它自行分包的分包施工单位和业主指定的分包施工单位的施工，代表施工方与业主方、设计方、工程监理方等外部单位进行必要的联系和协调等。监理方在施工阶段进行巡视、旁站和平行检验，对发现的质量问题应及时通知施工单位整改，并做监理记录。所以当监理工程师检查发现业主指定分包人施工的防水工程存在质量问题时应向总承包人发出监理通知单。
9. 一般情况下，验收合格工程的实际竣工日期为{{c1::（）}}。[2009年真题]	组织工程竣工验收的日期<br>承包人实际完成工程的日期<br>承包人提交竣工验收申请报告的日期<br>工程竣工验收后，发包人给予认可意见的日期	C	除专用合同条款另有约定外，经验收合格工程的实际竣工日期，以提交竣工验收申请报告的日期为准，并在工程接收证书中写明。
10. 根据《建设工程施工专业分包合同（示范文本）》（GF—2003—0213），不属于承包人责任和义务的是{{c1::（）}}。[2014年真题]	组织分包人参加发包人组织的图纸会审，向分包人进行设计图纸交底<br>负责整个施工场地的管理工作，协调分包人与同一施工场地的其他分包人之间的交叉配合<br>负责提供专业分包合同专用条款中约定的保修与试车，并承担由此发生的费用<br>随时为分包人提供确保分包工程施工所要求的施工场地和通道，满足施工运输需要	C	根据《建设工程施工专业分包合同（示范文本）》（GF—2003—0213），工程承包人的工作包括：①向分包人提供与分包工程相关的各种证件、批件和各种相关资料，向分包人提供具备施工条件的施工场地；②组织分包人参加发包人组织的图纸会审，向分包人进行设计图纸交底；③提供本合同专用条款中约定的设备和设施，并承担因此发生的费用；④随时为分包人提供确保分包工程的施工所要求的施工场地和通道等，满足施工运输的需要，保证施工期间的畅通；⑤负责整个施工场地的管理工作，协调分包人与同一施工场地的其他分包人之间的交叉配合，确保分包人按照经批准的施工组织设计进行施工。
11. 对专业分包企业的工作和负责的工程负有协调和管理责任并承担由此造成损失的单位是{{c1::（）}}。[2011年真题]	设计单位<br>建设单位<br>施工总承包企业<br>监理单位	C	工程总承包单位负责整个施工场地的管理工作，协调分包人与同一施工场地的其他分包人之间的交叉配合，确保分包人按照经批准的施工组织设计进行施工。
12. 根据《建设工程施工专业分包合同（示范文本）》（GF—2003—0213），关于发包人、承包人和分包人关系的说法，正确的是{{c1::（）}}。[2013年真题]	发包人向分包人提供具备施工条件的施工场地<br>就分包范围内的有关工作，承包人随时可以向分包人发出指令<br>分包人可直接致电发包人或工作师<br>分包合同价款与总承包合同相应部分价款存在连带关系	B	就分包工程范围内的有关工作，承包人随时可以向分包人发出指令，分包人应执行承包人根据分包合同所发出的所有指令。分包人拒不执行指令，承包人可委托其他施工单位完成该指令事项，发生的费用从应付给分包人的相应款项中扣除。
13. 根据《建设工程施工专业分包合同》（GF—2003—0213），下列说法正确的是{{c1::（）}}。[2010年真题]	发包人向分包人提供具备施工条件的施工场地<br>分包人可直接致函发包人或工程师<br>就分包范围内的有关工作，承包人随时可以向分包人发出指令<br>分包合同价款与总承包合同相应部分的价款存在连带关系	C	A项，承包人向分包人提供与分包工程相关的各种证件、批件和各种相关资料，向分包人提供具备施工条件的施工场地；B项，未经承包人允许，分包人不得以任何理由与发包人或工程师发生直接工作联系，分包人不得直接致函发包人或工程师，也不得直接接受发包人或工程师的指令；D项，分包合同价款与总承包合同相应部分价款无任何连带关系。
14. 根据《建设工程施工专业分包合同（示范文本）》（GF—2003—0213），承包人应在收到分包工程竣工结算报告及结算资料后{{c1::（）}}日内支付工程结算价款。[2012年真题]	7<br>14<br>28<br>42	C	承包人应在收到分包工程竣工结算报告及结算资料后28天内支付工程竣工结算价款，无正当理由不按时支付，从第29天起按分包人同期向银行贷款利率支付拖欠工程价款的利息，并承担违约责任。
15. 根据《建设工程施工劳务分包合同（示范文本）》（GF—2003—0214），劳务分包项目的施工组织设计应由{{c1::（）}}负责编制。[2013年真题]	发包人<br>监理人<br>劳务分包人<br>承包人	D	劳务分包合同条款中规定工程承包人的主要义务有负责编制施工组织设计，统一制定各项管理目标，组织编制年、季、月施工计划、物资需用量计划表，实施对工程质量、工期、安全生产、文明施工、计量检测、实验化验的控制、监督、检查和验收。
16. 根据《建设工程施工劳务分包合同（示范文本）》（GF—2003—0214），某工程承包人租赁一台起重机提供给劳务分包人使用，该起重机的保险应由{{c1::（）}}。[2015年真题]	工程承包人办理并支付保险费用<br>劳务分包人办理并支付保险费用<br>工程承包人办理，但由劳务分包人支付保险费用<br>劳务分包人办理，但由承包人支付保险费用	A	劳务作业分包，是指施工承包单位或者专业分包单位（均可作为劳务作业的发包人）将其承包工程中的劳务作业发包给劳务分包单位（即劳务作业承包人）完成的活动。根据《建设工程施工劳务分包合同（示范文本）》（GF—2003—0214）规定，工程承包人必须为租赁或提供给劳务分包人使用的施工机械设备办理保险，并支付保险费用。
17. 根据《建设工程施工劳务分包合同（示范文本）》（GF—2003—0214），全部分包工作完成，经工程承包人认可后{{c1::（）}}日内，劳务分包人向工程承包人递交完整的结算资料，按照合同约定进行劳务报酬的最终支付。[2012年真题]	7<br>14<br>28<br>42	B	根据《建设工程施工劳务分包合同（示范文本）》（GF—2003—0214），全部工作完成，经工程承包人认可后14天内，劳务分包人向工程承包人递交完整的结算资料，双方按照本合同约定的计价方式，进行劳务报酬的最终支付。
18. 某建设项目施工合同约定，由承包人负责采购项目所需的断桥隔热门窗，现设计要求的质量标准高于国家标准，则在材料采购合同中，对该材料的质量标准约定应按{{c1::（）}}执行。[2010年真题]	相应的企业标准<br>设计要求<br>颁布的国家标准<br>颁布的国家标准与设计要求综合确定的标准	B	标的物的质量要求应该符合国家或者行业现行有关质量标准和设计要求，应该符合以产品采用标准、说明、实物样品等方式表明的质量状况。约定质量标准的一般原则包括：①按颁布的国家标准执行；②没有国家标准而有部颁标准的则按照部颁标准执行；③没有国家标准和部颁标准为依据时，可按照企业标准执行；④没有上述标准或虽有上述标准但采购方有特殊要求，按照双方在合同中约定的技术条件、样品或补充的技术要求执行。
19. 按验收方式划分，建设工程采购方在所购物资制造时就派人在供应厂家进行检验的验收方式，属于{{c1::（）}}。[2012年真题]	驻厂验收<br>提运验收<br>接运验收<br>入库验收	A	建筑材料采购合同的主要内容包括：①标的；②数量；③包装；④交付及运输方式；⑤验收。其中，验收的方式有：①驻厂验收，在制造时期，由采购方派人在供应的生产厂家进行材质检验；②提运验收，对加工订制、市场采购和自提自运的物资，由提货人在提取产品时检验；③接运验收，由接运人员对到达的物资进行检查，发现问题当场作出记录；④入库验收，是广泛采用的正式的验收方法，由仓库管理人员负责数量和外观检验。
20. 建筑材料采购合同中约定供货方负责送货的，交货日期应以{{c1::（）}}为准。[2011年真题]	供货方发货戳记的日期<br>采购方收货戳记的日期<br>合同约定的提货日期<br>承运单位签发的日期	B	在建筑材料采购合同中，应明确具体的交货时间。如果分批交货，要注明各个批次的交货时间。交货日期可以按照下列方式确定：①供货方负责送货的，以采购方收货戳记的日期为准；②采购方提货的，以供货方按合同规定通知的提货日期为准；③凡委托运输部门或单位运输、送货或代运的产品，一般以供货方发运产品时承运单位签发的日期为准，不是以向承运单位提出申请的日期为准。
21. 建筑材料采购合同条款的相关说法，正确的是{{c1::（）}}。[2013年真题]	不属于国家定价的材料（产品），由供方确定价格<br>需方提货的，交货日期以需方收货戳记的日期为准<br>建筑材料的包装物由供方负责，并且一般不另向需方收费<br>建筑材料采购合同通常采用固定总价合同	C	A项，不属于国家定价的产品，可由供需双方协商确定价格；B项，采购方提货的，以供货方按合同规定通知的提货日期为准；D项，设备采购合同通常采用固定总价合同。
22. {{c1::（）}}应按专用合同条款约定的内容和期限，编制详细的施工进度计划和施工方案说明报送监理人。	投资人<br>承包人<br>发包人<br>分包人	B	承包人应按专用合同条款约定的内容和期限，编制详细的施工进度计划和施工方案说明报送监理人。监理人应在专用合同条款约定的期限内批复或提出修改意见，否则该进度计划视为已得到批准。
23. 由于施工机械出现故障导致工程暂停10天，此时承包人采取措施加快进度，由此增加的赶工费用应由{{c1::（）}}承担。	承包人<br>发包人<br>设备厂商<br>监理人	A	由于承包人原因，未能按合同进度计划完成工作，或监理人认为承包人施工进度不能满足合同工期要求的，承包人应采取措施加快进度，并承担加快进度所增加的费用。由于承包人原因造成工期延误，承包人应支付逾期竣工违约金。承包人支付逾期竣工违约金，不免除承包人完成工程及修补缺陷的义务。
24. 由于发包人的原因发生暂停施工的紧急情况，承包人可先暂停施工，并以______形式及时向监理人提出暂停施工的请求，监理人应在收到请求后______小时内予以答复。{{c1::（）}}	口头；48<br>书面；48<br>口头；24<br>书面；24	D	由于发包人的原因发生暂停施工的紧急情况，且监理人未及时下达暂停施工指示的，承包人可先暂停施工，并及时向监理人提出暂停施工的书面请求。监理人应在接到书面请求后的24小时内予以答复，逾期未答复的，视为同意承包人的暂停施工请求。
25. 承包人未通知监理人到场检查，私自将工程隐蔽部位覆盖的，监理人有权指示承包人钻孔探测或揭开检查，由此增加的费用由{{c1::（）}}承担。	发包人<br>监理人<br>监理人与承包人共同<br>承包人	D	承包人未通知监理人到场检查，私自将工程隐蔽部位覆盖的，监理人有权指示承包人钻孔探测或揭开检查，由此增加的费用和（或）工期延误由承包人承担。
26. 费用控制的主要条款不包括{{c1::（）}}。	预付款<br>工程进度款<br>竣工结算<br>风险预留金	D	费用控制的主要条款内容包括：预付款、工程进度款、质量保证金、竣工结算和最终结清。
27. 发包人于2015年11月1日收到了承包人的竣工验收申请报告，但直到2016年1月中旬，建设单位一直没有进行验收，则{{c1::（）}}。	施工单位应继续承担工程保管责任<br>施工单位可自行组织竣工验收<br>施工单位承担一切意外责任<br>以2015年11月1日为竣工日期	D	工程经竣工验收合格的，以承包人提交竣工验收申请报告之日为实际竣工日期，并在工程接收证书中载明；因发包人原因，未在监理人收到承包人提交的竣工验收申请报告42天内完成竣工验收，或完成竣工验收不予签发工程接收证书的，以提交竣工验收申请报告的日期为实际竣工日期；工程未经竣工验收，发包人擅自使用的，以转移占有工程之日为实际竣工日期。
28. 有关竣工验收的主要条款，下列说法不正确的是{{c1::（）}}。	监理人审查后认为已具备竣工验收条件的，应在收到竣工验收申请报告后的28天内提请发包人进行工程验收<br>竣工验收所采用的各项验收和评定标准应符合国家验收标准<br>承包人应按专用合同条款约定进行工程及工程设备试运行，负责提供试运行所需的人员、器材和必要的条件，发包人承担全部试运行费用<br>在施工期运行中发现工程或工程设备损坏或存在缺陷的，由承包人按合同规定进行修复	C	C项，除专用合同条款另有约定外，承包人应按专用合同条款约定进行工程及工程设备试运行，负责提供试运行所需的人员、器材和必要的条件，并承担全部试运行费用。
29. 缺陷责任期自{{c1::（）}}起计算。	工程验收日期<br>实际竣工日期<br>预计竣工日期<br>工程投入使用	B	缺陷责任期自实际竣工日期起计算。在全部工程竣工验收前，已经发包人提前验收的单位工程，其缺陷责任期的起算日期相应提前。
30. 在缺陷责任期，包括根据合同规定延长的期限终止后{{c1::（）}}天，由监理人向承包人出具经发包人签认的缺陷责任期终止证书，并退还剩余的质量保证金。	7<br>14<br>21<br>28	B	在缺陷责任期，包括根据合同规定延长的期限终止后14天内，由监理人向承包人出具经发包人签认的缺陷责任期终止证书，并退还剩余的质量保证金。
31. 下列属于承包人和专业工程分包人的共同责任或工作的是{{c1::（）}}。	向分包人提供与分包工程有关的各种证件、批件等和按照合同的约定，完成规定的设计内容<br>确保分包人按照经批准的施工组织设计进行施工和接受工程师的直接指令<br>转发发包人或工程师的指令和保证分包工程所需场地的通道畅通<br>为分包人从事危险作业的人员交付保险费用和分包人为承包人进入施工现场提供方便条件	A	B项，接受工程师的直接指令属于承包人的主要义务；C项，转发发包人或工程师的指令属于承包人的义务，保证分包工程所需场地的通道畅通属于承包人的工作；D项，为分包人从事危险作业的人员交付保险费用属于承包人的义务，分包人为承包人进入施工现场提供方便条件属于分包人的义务。
32. 根据施工专业分包合同示范文本规定，下列表述不正确的是{{c1::（）}}。	分包人须服从承包人转发的发包人或工程师与分包工程有关的指令<br>除本合同条款另有约定，分包人应履行并承担总包合同中与分包工程有关的承包人的所有义务与责任<br>就分包工程范围内的有关工作，承包人随时可以向分包人发出指令<br>分包人可以直接致函发包人或工程师，但不得直接接受发包人或工程师的指令	D	D项，未经承包人允许，分包人不得以任何理由与发包人或工程师（监理人）发生直接工作联系，分包人不得直接致函发包人或工程师（监理人），也不得直接接受发包人或工程师（监理人）的指令。
33. 关于分包人的工作，下列说法有误的是{{c1::（）}}。	对分包工程进行施工、竣工和保修<br>完成规定的设计内容，并直接在分包工程中使用<br>向承包人提供相应进度统计报表<br>在合同约定的时间内，向承包人提交详细施工组织设计	B	B项，分包人应按照合同约定的时间，完成规定的设计内容，报承包人确认后在分包工程中使用。
34. 根据《专业工程分包合同示范文本》规定，分包合同约定的工程变更调整的合同价款，应{{c1::（）}}。	与工程结算款同期支付<br>与工程进度款同期调整支付<br>单独支付<br>共同支付	B	分包合同约定的工程变更调整的合同价款、合同价款的调整、索赔的价款或费用以及其他约定的追加合同价款，应与工程进度款同期调整支付。
35. 劳务分包合同中，劳务分包人应{{c1::（）}}。	负责工程测量定位、沉降观测、技术交底<br>协调与发包人、监理、设计及有关部门的工作关系<br>自行准备有关的生产、生活临时设施<br>承担由于自身责任造成的质量修改、返工、工期拖延、安全事故、现场脏乱所造成的损失及各种罚款	D	AB两项属于工程承包人的主要义务；C项，工程承包人有责任向劳务分包人提供有关的生产、生活临时设施。
36. 关于劳务分包合同，下列说法正确的是{{c1::（）}}。	劳务分包人应为进入施工现场的第三方人员办理保险，并支付保险费用<br>劳务分包人必须为从事危险作业的职工办理意外伤害保险，并为施工场地内自有人员生命财产和施工机械设备办理保险，支付保险费用<br>采用固定价格时，无论发生任何情况，均为一次包死，不再调整<br>采用固定劳务报酬方式的，每次结算须计算工时和工程量	B	A项，劳务分包人施工开始前，工程承包人应获得发包人为施工场地内的自有人员及第三人人员生命财产办理的保险，且不需劳务分包人支付保险费用；C项，采用固定价格，则除合同约定或法律政策变化导致劳务价格变化以外，均为一次包死，不再调整；D项，采用固定劳务报酬方式的，施工过程中不计算工时和工程量。
37. 劳务分包合同中，工程承包人收到劳务分包人递交的结算资料后{{c1::（）}}天内进行核实。	14<br>28<br>21<br>7	A	劳务分包合同中，工程承包人收到劳务分包人递交的结算资料后14天内进行核实，给予确认或者提出修改意见。工程承包人确认结算资料后14天内向劳务分包人支付劳务报酬尾款。
38. 劳务分包合同中，约定不同工种劳务的计时单价，其劳务报酬应{{c1::（）}}。	按确认的工程量计算<br>按固定劳务报酬计算<br>按确认的工时计算<br>按确认的完成工作成果计算	C	劳务报酬可以采用的方法有：①固定劳务报酬（含管理费）；②约定不同工种劳务的计时单价（含管理费），按确认的工时计算；③约定不同工作成果的计件单价（含管理费），按确认的工程量计算。
39. 若劳务分包合同中规定采用按确定的工时计算劳务报酬，劳务发包人应{{c1::（）}}将劳务人数报工程承包人。	每12小时<br>每天<br>每周<br>每月	B	采用按确定的工时计算劳务报酬的，由劳务分包人每日将提供劳务人数报工程承包人，由工程承包人确认。
40. 对劳务分包人未经工程承包人认可，超出设计图纸范围和因劳务分包人原因造成返工的工程量{{c1::（）}}。	予以计量<br>按百分比测量<br>酌情考虑<br>不予计量	D	对劳务分包人未经工程承包人认可，超出设计图纸范围和因劳务分包人原因造成返工的工程量，工程承包人不予计量。
41. 建筑材料采购合同中应该明确货物的验收依据，下列不属于验收依据的是{{c1::（）}}。	双方当事人封存的样品<br>产品合格证、检验单<br>供货方提供的试验样品<br>合同约定的质量标准和要求	C	建筑材料采购合同中有关货物的验收依据包括：①采购合同；②供货方提供的发货单、计量单、装箱单及其他有关凭证；③合同约定的质量标准和要求；④产品合格证、检验单；⑤图纸、样品和其他技术证明文件；⑥双方当事人封存的样品。
42. 设备制造前，采购方应支付设备价格的{{c1::（）}}作为预付款。	20%<br>15%<br>10%<br>8%	C	设备采购合同价款的支付一般分三次：①设备制造前，采购方支付设备价格的10%作为预付款；②供货方按照交货顺序在规定的时间内将货物送达交货地点，采购方支付该批设备价的80%；③剩余的10%作为设备保证金，待保证期满，采购方签发最终验收证书后支付。
43. 设备采购合同中的技术标准不包括{{c1::（）}}。	设备系统的主要技术性能<br>设备系统的主要技术标准<br>各部分设备的主要技术标准<br>各部分设备的技术性能	B	设备采购合同中的技术标准包括设备系统的主要技术性能，以及各部分设备的主要技术标准和技术性能。
