1. 在民事诉讼证据认定中，不能单独作为认定案件事实依据的有{{c1::（）}}。[2017年真题]	以严重违背公序良俗的方法获取的证据<br>未成年人所作的与其年龄和智力状况不相当的证言<br>无正当理由未出庭作证的证人证言<br>与一方当事人的代理人有利害关系的证人出具的证言<br>无法与原件、原物核对的复印件、复制品	B|C|D|E	不能单独作为认定案件事实的证据包括：①未成年人所作的与其年龄和智力状况不相当的证言；②与一方当事人或者其代理人有利害关系的证人出具的证言；③存有疑点的视听材料；④无法与原件、原物核对的复印件、复制品；⑤无正当理由未出庭作证的证人证言。A项，对以严重侵害他人合法权益、违反法律禁止性规定或者严重违背公序良俗的方法形成或者获取的证据，不得作为认定案件事实的根据。
2. 符合《民事诉讼法》关于级别管辖和专属管辖规定的情况下，合同当事人可以书面协议选择的管辖法院有{{c1::（）}}。[2016年真题]	被告住所地人民法院<br>合同履行地人民法院<br>合同纠纷发生地人民法院<br>标的物所在地人民法院<br>合同签订地人民法院	A|B|D|E	根据《民事诉讼法》第三十四条规定，合同或者其他财产权益纠纷的当事人可以书面协议选择被告住所地、合同履行地、合同签订地、原告住所地、标的物所在地等与争议有实际联系的地点的人民法院管辖，但不得违反本法对级别管辖和专属管辖的规定。
3. 无独立请求权的第三人，其诉讼权利包括{{c1::（）}}。[2015年真题]	申请提起诉讼<br>申请参加诉讼<br>提起反诉<br>由法院通知参加诉讼<br>申请提起公益诉讼	B|D	《民事诉讼法》规定，对当事人双方的诉讼标的，第三人认为有独立请求权的，有权提起诉讼。对当事人双方的诉讼标的，第三人虽然没有独立请求权，但案件处理结果同他有法律上的利害关系的，可以申请参加诉讼，或者由人民法院通知他参加诉讼。
4. 当事人提交给法院的以下材料中，不属于民事诉讼证据的有{{c1::（）}}。［2010年真题］	建筑工程法规<br>建筑材料检验报告<br>工程竣工验收现场录像<br>双方往来的电子邮件<br>代理意见	A|E	民事诉讼证据包括八种证据形式，即：①当事人陈述；②书证；③物证；④电子数据；⑤视听资料；⑥证人证言；⑦鉴定意见；⑧勘验笔录。
5. 下列情形中，人民法院应当再审的有{{c1::（）}}。［2013年真题］	管辖错误的<br>剥夺当事人辩论权利的<br>缺席判决的<br>原判决超出诉讼请求的<br>审判庭组成不合法	D|E	《民事诉讼法》第二百条规定，当事人的申请符合下列情形之一的，人民法院应当再审：①有新的证据，足以推翻原判决、裁定的；②原判决、裁定认定的基本事实缺乏证据证明的；③原判决、裁定认定事实的主要证据是伪造的；④原判决、裁定认定事实的主要证据未经质证的；⑤对审理案件需要的主要证据，当事人因客观原因不能自行收集，书面申请人民法院调查收集，人民法院未调查收集的；⑥原判决、裁定适用法律确有错误的；⑦审判组织的组成不合法或者依法应当回避的审判人员没有回避的；⑧无诉讼行为能力人未经法定代理人代为诉讼或者应当参加诉讼的当事人，因不能归责于本人或者其诉讼代理人的事由，未参加诉讼的；⑨违反法律规定，剥夺当事人辩论权利的；⑩未经传票传唤，缺席判决的；原判决、裁定遗漏或者超出诉讼请求的；据以作出原判决、裁定的法律文书被撤销或者变更的；审判人员审理该案件时有贪污受贿，徇私舞弊，枉法裁判行为的。
6. 有下列情形中{{c1::（）}}的，法院应当裁定中止执行。［2007年真题］	申请人表示可以延期执行<br>申请人撤销申请<br>案外人对执行标的提出确有理由的异议<br>作为一方当事人的公民死亡，需要等待继承人继承权利或者承担义务<br>作为一方当事人的法人或者其他组织终止，尚未确定权利义务承受人	A|C|D|E	执行中止指在执行过程中，因发生特殊情况，需要暂时停止执行程序。有下列情况之一的，人民法院应裁定中止执行：①申请人表示可以延期执行的；②案外人对执行标的提出确有理由异议的；③作为一方当事人的公民死亡，需要等待继承人继承权利或承担义务的；④作为一方当事人的法人或其他组织终止，尚未确定权利义务承受人的；⑤人民法院认为应当中止执行的其他情形，如被执行人确无财产可供执行等。中止的情形消失后，恢复执行。
7. 根据《民事诉讼法》，属于广义民事诉讼当事人的有{{c1::（）}}。[2014年真题]	第三人<br>刑事附带民事案件自诉人<br>辩护人<br>原告与被告<br>共同诉讼人	A|D|E	民事诉讼中的当事人，是指因民事权利和义务发生争议，以自己的名义进行诉讼，请求人民法院进行裁判的公民、法人或其他组织。狭义的民事诉讼当事人包括原告和被告。广义的民事诉讼当事人包括原告、被告、共同诉讼人和第三人。
8. 严某在某市A区新购一套住房，并请位于该市B区的装修公司进行装修。装修人员不慎将水管弄破，导致该楼下住户家具被淹毁。严某交涉未果，遂向该市B区法院起诉装修公司，B区法院裁定将案件移送至A区法院，A区法院又将案件退回B区法院。关于本案管辖，说法正确的有{{c1::（）}}。	A区法院对该案有管辖权<br>严某有权向B区法院起诉<br>B区法院的移送管辖是错误的<br>A、B区法院均无管辖权<br>A区法院不接受移送，将案件退回B区法院是错误的	A|B|C|E	一般地域管辖，是以当事人与法院的隶属关系来确定诉讼管辖，通常实行“原告就被告”原则，即以被告住所地作为确定管辖的标准。《民事诉讼法》第二十三条规定，因合同纠纷提起的诉讼，由被告住所地或者合同履行地人民法院管辖。第三十六条规定，人民法院发现受理的案件不属于本院管辖的，应当移送有管辖权的人民法院，受移送的人民法院应当受理。受移送的人民法院认为受移送的案件依照规定不属于本院管辖的，应当报请上级人民法院指定管辖，不得再自行移送。
9. 根据《民事诉讼法》，下列案件纠纷适用专属管辖的有{{c1::（）}}。	货物运输<br>人身伤害<br>房屋权属<br>土地使用权转让<br>建设工程施工合同	C|D|E	专属管辖是指法律规定某些特殊类型的案件专门由特定的法院管辖。《民事诉讼法》中规定了3种适用专属管辖的案件，其中因不动产纠纷提起的诉讼，由不动产所在地人民法院管辖，如房屋买卖纠纷、土地使用权转让纠纷等。《最高人民法院关于适用〈中华人民共和同民事诉讼法〉的解释》中规定，建设工程施工合同纠纷按照不动产纠纷确定管辖。
10. 根据《民事诉讼法》，合同当事人可以在书面合同中协议选择{{c1::（）}}人民法院管辖。	双方约定的其他地方<br>原告住所地<br>被告住所地<br>合同履行地<br>合同签订地	B|C|D|E	《民事诉讼法》第三十四条规定，合同或者其他财产权益纠纷的当事人可以书面协议选择被告住所地、合同履行地、合同签订地、原告住所地、标的物所在地等与争议有实际联系的地点的人民法院管辖，但不得违反本法对级别管辖和专属管辖的规定。
11. 下列关于仲裁与诉讼特点的表述正确的有{{c1::（）}}。	仲裁的程序相对灵活，诉讼的程序较严格<br>仲裁以不公开审理为原则，诉讼则以不公开审理为例外<br>仲裁实行一裁终局制，诉讼实行两审终审制<br>仲裁机构由双方协商确定，管辖人民法院则不能由双方约定<br>仲裁和诉讼是两种独立的争议解决方式	A|B|C|E	D项，《民事诉讼法》规定，合同或者其他财产权益纠纷的当事人可以在书面合同中协议选择被告住所地、合同履行地、合同签订地、原告住所地、标的物所在地等与争议有实际联系的地点的人民法院管辖。因此诉讼中当事人可以依法有条件地约定管辖法院。
12. 当事人在诉讼中提交的证据，在下列表述中，正确的有{{c1::（）}}。	书证应当提交原件<br>书证原件遗失，不可以提交副本<br>物证应当提交原物<br>物证原物遗失，不可以用复制品代替<br>提交外文书证，不必附有中文译本	A|C	当事人在诉讼中提交证据时，书证应当提交原件，物证应当提交原物。提交原件或者原物确有困难的，可以提交复制品、照片、副本、节录本。提交外文书证，必须附有中文译本。
13. 下列证据属于书证的有{{c1::（）}}。	当事人亲笔签字的合同书<br>作为债权债务纠纷诉讼证据的债务人亲自书写的借条<br>作为工程承包纠纷诉讼证据的工程设计图纸<br>作为侵权诉讼证据的盗版书籍<br>作为招投标纠纷诉讼证据的投标标书	A|B|C|E	书证，是指以文字、符号所记录或表示的，以证明待证事实的文书，如合同、书信、文件、票据等。书证是民事诉讼和仲裁中普遍并大量应用的一种证据。D项，作为侵权诉讼证据的盗版书籍以其存在的外形本身证明侵权事实的存在，故属于物证。
14. 为制止侵权行为，权利人在起诉前向人民法院申请保全证据。保全方法正确的有{{c1::（）}}。	对文书、物品等进行录像、拍照、抄写<br>对文书、物品等进行复制<br>向证人进行询问调查、记录证人证言<br>对证据进行鉴定或勘验<br>将获取的证据材料交给当事人保管	A|B|C|D	人民法院进行证据保全，可以根据具体情况，采用查封、扣押、拍照、录音、录像、复制、鉴定、勘验、制作笔录等方法。E项，当事人无权保管证据保全所获取的证据资料。
15. 一方当事人提出的下列{{c1::（）}}证据，对方当事人提出异议但没有足以反驳的相反证据的，人民法院应当确认其证明力。	书证原件或者与书证原件核对无误的复印件、照片、副本、节录本<br>无法与原件、原物核对的复印件、复制品<br>无正当理由未出庭作证的证人证言<br>一方当事人申请人民法院依照法定程序制作的对物证或者现场的勘验笔录<br>存有疑点的视听资料	A|D	《最高人民法院关于民事诉讼证据的若干规定》第七十条规定，一方当事人提出的下列证据，对方当事人提出异议但没有足以反驳的相反证据的，人民法院应当确认其证明力：①书证原件或者与书证原件核对无误的复印件、照片、副本、节录本；②物证原物或者与物证原物核对无误的复制件、照片、录像资料等；③有其他证据佐证并以合法手段取得的，无疑点的视听资料或者与视听资料核对无误的复制件；④一方当事人申请人民法院依照法定程序制作的对物证或者现场的勘验笔录。
16. 下列债权请求权提出诉讼时效抗辩的，法院不予支持的有{{c1::（）}}。	支付存款本金及利息请求权<br>兑付国债、金融债券本息请求权<br>基于投资关系产生的缴付出资请求权<br>从权利被侵害之日起不超过3年的请求权<br>向不特定对象发行的企业债券本息请求权	A|B|C|E	当事人可以对债权请求权提出诉讼时效抗辩，但对下列债权请求权提出诉讼时效抗辩的，法院不予支持：①支付存款本金及利息请求权；②兑付国债、金融债券以及向不特定对象发行的企业债券本息请求权；③基于投资关系产生的缴付出资请求权；④其他依法不适用诉讼时效规定的债权请求权。
17. 以下关于诉讼时效的说法正确的有{{c1::（）}}。	普通诉讼时效期间通常为3年<br>兑付国债、金融债券本息请求权诉讼时效为3年<br>因国际货物买卖合同和技术进出口合同争议的时效期间为2年<br>从权利被侵害之日起超过10年的，法院不予保护<br>特殊诉讼时效不是由民法规定的，而是由特别法规定的诉讼时效	A|E	根据我国《民法总则》及有关法律的规定，诉讼时效期间通常可划分为4类：①普通诉讼时效，即向人民法院请求保护民事权利的期间。普通诉讼时效期间通常为3年。②特殊诉讼时效。特殊诉讼时效不是由民法规定的，而是由特别法规定的诉讼时效。例如，《合同法》规定，因国际货物买卖合同和技术进出口合同争议的时效期间为4年；《海商法》规定，就海上货物运输向承运人要求赔偿的请求权，时效期间为1年。④权利的最长保护期限。诉讼时效期间自权利人知道或应当知道权利受到损害以及义务人之日起计算。但是，从权利被侵害之日起超过20年的，法院不予保护；有特殊情况的，人民法院可以根据权利人的申请决定延长。当事人可以对债权请求权提出诉讼时效抗辩，但对下列债权请求权提出诉讼时效抗辩的，法院不予支持：①支付存款本金及利息请求权；②兑付国债、金融债券以及向不特定对象发行的企业债券本息请求权；③基于投资关系产生的缴付出资请求权；④其他依法不适用诉讼时效规定的债权请求权。
18. 下列对诉讼时效中止的说法正确的有{{c1::（）}}。	权利人由于不可抗力或者其他障碍，不能行使请求权<br>权利人对同一债权中的部分债权主张权利<br>导致权利人不能行使请求权的事由发生在诉讼时效期间的最后6个月内<br>申请破产、申报破产债权<br>当事人一方同意履行义务	A|C	诉讼时效中止，应当同时满足两个条件：①权利人由于不可抗力或者其他障碍，不能行使请求权；②导致权利人不能行使请求权的事由发生在诉讼时效期间的最后6个月内。BDE三项属于诉讼时效中断的情形。
19. 甲施工企业承建乙公司综合楼一幢。根据施工合同，乙应于2016年4月10日前支付剩余工程款50万元，乙届时未予支付。甲在索要余款过程中，依次经过以下环节，综合考虑各环节，其中可使诉讼时效中断的情形有{{c1::（）}}。	2016年5月，甲致函乙要求其给付工程款<br>2016年5月，乙公司负责人在酒席上向甲施工企业负责人表示宽限一年，2016年年底一定付款<br>2016年6月，乙公司新任负责人称该债务系前任领导所欠，自己概不负责<br>2017年5月，乙公司承认该债务存在，但其已超过诉讼时效期间而拒绝支付<br>2017年3月，甲向人民法院起诉	A|B|E	《民法总则》第一百九十五条规定，有下列情形之一的，诉讼时效中断，从中断、有关程序终结时起，诉讼时效期间重新起算：①权利人向义务人提出履行请求；②义务人同意履行义务；③权利人提起诉讼或者申请仲裁；④与提起诉讼或者申请仲裁具有同等效力的其他情形。。
20. 根据《民事诉讼法》，起诉必须符合的条件有{{c1::（）}}。	原告是与本案有直接利害关系的公民，法人和其他组织<br>有明确的被告<br>有具体的诉讼请求和理由<br>事实清楚，证据确实充分<br>属于人民法院受理民事诉讼的范围和受诉人民法院管辖	A|B|C|E	《民事诉讼法》第一百一十九条规定，起诉必须符合下列条件：①原告是与本案有直接利害关系的公民、法人和其他组织；②有明确的被告；③有具体的诉讼请求、事实和理由；④属于人民法院受理民事诉讼的范围和受诉人民法院管辖。
21. 在民事诉讼程序中，下列情形可以缺席判决的有{{c1::（）}}。	原告经传票传唤，无正当理由拒不到庭，被告反诉<br>原告未经法庭许可中途退庭<br>原告未经法庭许可中途退庭，被告反诉<br>被告未经法庭许可中途退庭<br>被告经传票传唤，无正当理由拒不到庭	A|C|D|E	根据《民事诉讼法》，原告经传票传唤，无正当理由拒不到庭的，或者未经法庭许可中途退庭的，可以按撤诉处理；被告反诉的，可以缺席判决。被告经传票传唤，无正当理由拒不到庭的，或者未经法庭许可中途退庭的，可以缺席判决。
22. 下列文书中，具有强制约束力、可以作为执行依据的法律文书包括{{c1::（）}}。	当事人自愿达成的和解协议<br>仲裁调解书<br>公证债权文书<br>民事判决书<br>民事裁定书	B|C|D|E	根据《民事诉讼法》的有关规定，具有强制约束力，可以作为执行依据的法律文书包括：①人民法院制作的发生法律效力的民事判决书、裁定书以及生效的调解书等；②人民法院作出的具有财产给付内容的发生法律效力的刑事判决书、裁定书；③仲裁机构制作的依法由人民法院执行的生效仲裁裁决书、仲裁调解书；④公证机关依法作出的赋予强制执行效力的公证债权文书；⑤人民法院作出的先予执行的裁定、执行回转的裁定以及承认并协助执行外国判决、裁定或裁决的裁定；⑥我国行政机关作出的法律明确规定由人民法院执行的行政决定；⑦人民法院依督促程序发布的支付令等。
23. 下列关于执行中的和解的说法，正确的有{{c1::（）}}。	在执行中，双方当事人可以自行和解，达成协议<br>当事人申请法院执行后，不能再就执行内容进行和解<br>在执行中达成和解协议后，如果一方当事人不履行和解协议的，人民法院应当终结执行<br>在执行中达成和解协议后，如果一方当事人不履行和解协议的，人民法院可以根据对方当事人的申请，恢复对原生效法律文书的执行<br>在执行中达成和解协议后，如果一方当事人不履行和解协议的，人民法院应当告知另一方当事人重新申请执行	A|D	在执行中，双方当事人自行和解达成协议的，执行员应当将协议内容记入笔录，由双方当事人签名或者盖章。一方当事人不履行和解协议的，人民法院可以根据对方当事人的申请，恢复对原生效法律文书的执行。
24. 执行措施是法院依法强制执行生效法律文书的方法和手段。根据我国《民事诉讼法》的规定，执行措施主要包括{{c1::（）}}。	查询、冻结、划拨被执行人的存款<br>扣留、提取被执行人的收入<br>查封、扣押、拍卖、变卖被执行人的财产<br>搜查被执行人隐匿的财产<br>强制第三人交付法律文书指定的财物或票证	A|B|C|D	执行措施是指人民法院依照法定程序强制执行生效法律文书的方法和手段。除ABCD四项外，执行措施还包括：①强制被执行人和有关单位、公民交付法律文书指定的财物或票证；②强制被执行人迁出房屋或退出土地；③强制被执行人履行法律文书指定的行为；④办理财产权证照转移手续；⑤强制被执行人支付迟延履行期间的债务利息或迟延履行金；⑥依申请执行人申请，通知对被执行人负有到期债务的第三人向申请执行人履行债务。
