1. 关于施工企业专职安全生产管理人员职责的说法，正确的是{{c1::（）}}。[2017年真题]	组织制定本单位安全生产操作规程<br>编制安全专项施工方案<br>如实记录安全生产教育和培训情况<br>建立健全本单位安全生产责任制	C	A项，施工企业专职安全生产管理人员应组织或者参与拟订本单位安全生产规章制度、操作规程和生产安全事故应急救援预案，组织制定本单位安全生产操作规程是生产经营单位的主要负责人的职责；B项，施工单位应对达到一定规模的危险性较大的分部分项工程编制专项施工方案，并附具安全验算结果，经施工单位技术负责人、总监理工程师签字后实施，由专职安全生产管理人员进行现场监督；D项是生产经营单位的主要负责人的职责。
2. 关于专职安全生产管理人员配备要求的说法，正确的是{{c1::（）}}。[2017年真题]	按建筑施工总承包企业资质管理要求，资质等级越高则专职安全生产管理人员配备越多<br>建筑施工企业经营规模较小的，可以不配备专职安全生产管理人员<br>建筑施工企业的分支机构不必配备专职安全生产管理人员<br>作业难度大的施工作业班组必须配备专职安全生产管理人员	A	ABC三项，建筑施工企业安全生产管理机构专职安全生产管理人员的配备应满足下列要求，并应根据企业经营规模、设备管理和生产需要予以增加：①建筑施工总承包资质序列企业：特级资质不少于6人；一级资质不少于4人；二级和二级以下资质企业不少于3人；②建筑施工专业承包资质序列企业：一级资质不少于3人；二级和二级以下资质企业不少于2人。③建筑施工劳务分包资质序列企业：不少于2人；④建筑施工企业的分公司、区域公司等较大的分支机构应依据实际生产情况配备不少于2人的专职安全生产管理人员。D项，施工作业班组可以设置兼职安全巡查员，对本班组的作业场所进行安全监督检查。
3. 下列安全生产责任中，属于施工单位安全生产管理机构专职安全生产管理人员责任的是{{c1::（）}}。[2015年真题]	落实制定安全生产规章制度和操作规程<br>确保安全生产费用的有效使用<br>检查危险性较大工程安全专项施工方案的落实情况<br>组织制定安全施工措施	C	建筑施工企业安全生产管理机构专职安全生产管理人员在施工现场检查过程中具有以下职责：①查阅在建项目安全生产有关资料、核实有关情况；②检查危险性较大工程安全专项施工方案落实情况；③监督项目专职安全生产管理人员履责情况；④监督作业人员安全防护用品的配备及使用情况；⑤对发现的安全生产违章违规行为或安全隐患，有权当场予以纠正或作出处理决定；⑥对不符合安全生产条件的设施、设备、器材，有权当场作出查封的处理决定；⑦对施工现场存在的重大安全隐患有权越级报告或直接向建设主管部门报告；⑧企业明确的其他安全生产管理职责。
4. 施工企业的项目负责人应当对{{c1::（）}}负责。［2013年真题］	本单位的安全生产<br>建设工程项目的安全施工<br>本单位安全生产所需资金<br>危险性较大的专项施工方案确定	B	施工企业的项目负责人是指建设工程项目的项目经理。《建设工程安全生产管理条例》规定，施工单位的项目负责人应当由取得相应执业资格的人员担任，对建设工程项目的安全施工负责，落实安全生产责任制度、安全生产规章制度和操作规程，确保安全生产费用的有效使用，并根据工程的特点组织制定安全施工措施，消除安全事故隐患，及时、如实报告生产安全事故。
5. 工程项目质量安全第一责任人是{{c1::（）}}。［2014年真题］	总经理<br>部门经理<br>安全经理<br>项目经理	D	施工项目负责人是指建设工程项目的项目经理。《建筑施工企业负责人及项目负责人施工现场带班暂行办法》规定，项目负责人是工程项目质量安全管理的第一责任人，应对工程项目落实带班制度负责。
6. 根据《建设工程安全生产管理条例》，总承包单位和分包单位对分包工程的安全生产承担{{c1::（）}}。[2016年真题]	按份责任<br>集体责任<br>同等责任<br>连带责任	D	根据《建设工程安全生产管理条例》第二十四条第三款规定，总承包单位依法将建设工程分包给其他单位的，分包合同中应当明确各自的安全生产方面的权利、义务。总承包单位和分包单位对分包工程的安全生产承担连带责任。
7. 关于建筑工程的发包、承包方式，以下说法错误的是{{c1::（）}}。［2009年真题］	建筑工程的发包方式分为招标发包和直接发包<br>未经发包方同意且无合同约定，承包方不得对专业工程进行分包<br>联合体各成员对承包合同的履行承担连带责任<br>发包方有权将单位工程的地基基础、主体结构、屋面等工程分别发包给符合资质的施工单位	D	D项，《建设工程安全生产管理条例》第二十四条第二款规定，总承包单位应当自行完成建设工程主体结构的施工。
8. 根据《建设工程安全生产管理条例》，施工单位的相关人员未经安全教育培训或经考核不合格即从事相关工作的，应责令限期改正，逾期未改正的，责令停业整顿。下列人员中，属于“相关人员”范围的是{{c1::（）}}。[2015年真题]	安全员<br>资料员<br>材料员<br>标准员	A	《建设工程安全生产管理条例》第六十二条第二项规定，违反本条例的规定，施工单位的主要负责人、项目负责人、专职安全生产管理人员、作业人员或者特种作业人员，未经安全教育培训或者经考核不合格即从事相关工作的，责令限期改正；逾期未改正的，责令停业整顿，依照《中华人民共和国安全生产法》的有关规定处以罚款；造成重大安全事故，构成犯罪的，对直接责任人员，依照刑法有关规定追究刑事责任。
9. 根据《国务院安委会关于进一步加强安全培训工作的决定》，高危企业新职工安全培训合格后，要在经验丰富的工人师傅带领下，实习至少{{c1::（）}}后方可独立上岗。[2016年真题]	6个月<br>3个月<br>2个月<br>1个月	C	根据《国务院安委会关于进一步加强安全培训工作的决定》，完善和落实师傅带徒弟制度。高危企业新职工安全培训合格后，要在经验丰富的工人师傅带领下，实习至少2个月后方可独立上岗。工人师傅一般应当具备中级工以上技能等级，3年以上相应工作经历，成绩突出，善于“传、帮、带”，没有发生过“三违”行为等条件。要组织签订师徒协议，建立师傅带徒弟激励约束机制。
10. 根据《安全生产法》，对于未如实记录安全生产教育和培训情况的生产经营单位，可以{{c1::（）}}。[2016年真题]	降低资质等级<br>给予警告<br>吊销营业执照<br>责令限期改正	D	根据《安全生产法》第九十四条第四项规定，生产经营单位未如实记录安全生产教育和培训情况的，责令限期改正，可以处5万元以下的罚款；逾期未改正的，责令停产停业整顿，并处5万元以上10万元以下的罚款，对其直接负责的主管人员和其他直接责任人员处1万元以上2万元以下的罚款。
11. 施工企业项目经理未履行安全生产管理职责，被施以刑罚，依法5年内不得担任任何施工企业的主要负责人、项目负责人，该期间的起算时间为{{c1::（）}}。［2014年真题］	犯罪行为发生之日<br>刑罚执行完毕之日<br>案件移送审查之日<br>刑事判决生效之日	B	《建设工程安全生产管理条例》规定，施工单位的主要负责人、项目负责人未履行安全生产管理职责的，责令限期改正；逾期未改正的，责令施工单位停业整顿；造成重大安全事故、重大伤亡事故或者其他严重后果，构成犯罪的，依照刑法有关规定追究刑事责任。施工单位的主要负责人、项目负责人有以上违法行为，尚不够刑事处罚的，处2万元以上20万元以下的罚款或者按照管理权限给予撤职处分；自刑罚执行完毕或者受处分之日起，5年内不得担任任何施工单位的主要负责人、项目负责人。
12. 下列情形中，属于施工作业人员的安全生产义务的是{{c1::（）}}。	对本单位的安全生产工作提出建议<br>接受安全生产教育和培训<br>发现直接危及人身安全的紧急情况时停止作业<br>拒绝违章指挥和强令冒险作业	B	按照《建筑法》、《安全生产法》、《建设工程安全生产管理条例》等法律、行政法规的规定，施工作业人员主要应当履行以下安全生产义务：①守法遵章和正确使用安全防护用具等的义务；②接受安全生产教育培训的义务；③施工安全事故隐患报告的义务。
13. 下列施工单位人员中，不必经建设主管部门考核合格即可任职的是{{c1::（）}}。	项目安全生产管理人员<br>项目技术员<br>企业主要负责人<br>项目经理	B	《建设工程安全生产管理条例》第三十六条第一款规定，施工单位的主要负责人、项目负责人、专职安全生产管理人员应当经建设行政主管部门或者其他有关部门考核合格后方可任职。
14. 建筑施工企业的管理人员和作业人员每{{c1::（）}}应至少进行1次安全生产教育培训并考核合格。	6个月<br>2年<br>1年<br>3年	C	《建设工程安全生产管理条例》第三十六条第二款规定，施工单位应当对管理人员和作业人员每年至少进行1次安全生产教育培训，其教育培训情况记入个人工作档案。安全生产教育培训考核不合格的人员，不得上岗。
15. 下列关于施工单位安全生产责任制度的说法，正确的是{{c1::（）}}。	施工单位主要负责人是指施工单位法定代表人<br>专职安全生产管理人员对项目的安全施工负责<br>专职安全生产管理人员应常驻现场对安全生产进行监督检查<br>装修工程应按照工程总造价配备相应数量的专职安全生产管理人员	C	C项，《建设工程安全生产管理条例》第二十三条规定，施工单位应当设立安全生产管理机构，配备专职安全生产管理人员。专职安全生产管理人员负责对安全生产进行现场监督检查。发现安全事故隐患，应当及时向项目负责人和安全生产管理机构报告；对违章指挥、违章操作的，应当立即制止。A项，施工单位主要负责人通常是指对施工单位全面负责，有生产经营决策权的人。具体说，可以是施工企业的董事长，也可以是总经理或总裁等。B项，施工单位的项目负责人应当由取得相应执业资格的人员担任，对建设工程项目的安全施工负责。D项，建筑工程、装修工程按专业配备专职安全生产管理人员。
16. 建筑施工总承包特级资质企业，应至少配备{{c1::（）}}名专职安全生产管理人员。	8<br>6<br>4<br>3	B	《建筑施工企业安全生产管理机构设置及专职安全生产管理人员配备办法》第八条规定，建筑施工企业安全生产管理机构专职安全生产管理人员的配备应满足下列要求，并应根据企业经营规模、设备管理和生产需要予以增加：①建筑施工总承包资质序列企业，特级资质不少于6人；一级资质不少于4人；二级和二级以下资质企业不少于3人。②建筑施工专业承包资质序列企业，一级资质不少于3人；二级和二级以下资质企业不少于2人。③建筑施工劳务分包资质序列企业，不少于2人。④建筑施工企业的分公司、区域公司等较大的分支机构应依据实际生产情况配备不少于2人的专职安全生产管理人员。
17. 根据《建筑施工企业主要负责人、项目负责人和专职安全生产管理人员安全生产管理规定》，下列说法正确的是{{c1::（）}}。	企业主要负责人、项目负责人和专职安全生产管理人员合称为“安管人员”<br>安全生产考核合格证书有效期为2年，证书在全国范围内有效<br>建筑施工企业应当建立安全生产教育培训制度，制定年度培训计划，每季度对“安管人员”进行培训和考核<br>专职安全生产管理人员分为土建、安装、综合三类，综合类专职安全生产管理人员可以从事全部安全生产管理工作	A	《建筑施工企业主要负责人、项目负责人和专职安全生产管理人员安全生产管理规定》规定，企业主要负责人、项目负责人和专职安全生产管理人员合称为“安管人员”。B项，安全生产考核合格证书有效期为3年，证书在全国范围内有效。C项，建筑施工企业应当建立安全生产教育培训制度，制定年度培训计划，每年对“安管人员”进行培训和考核，考核不合格的，不得上岗。D项，专职安全生产管理人员分为机械、土建、综合三类。机械类专职安全生产管理人员可以从事起重机械、土石方机械、桩工机械等安全生产管理工作。土建类专职安全生产管理人员可以从事除起重机械、土石方机械、桩工机械等安全生产管理工作以外的安全生产管理工作。综合类专职安全生产管理人员可以从事全部安全生产管理工作。
18. 某建设项目实行施工总承包，则该建设工程的安全生产事故应急救援预案应由{{c1::（）}}编制。	监理单位统一组织<br>总承包单位统一组织<br>总承包单位和分包单位各自组织<br>建设单位统一组织	B	《建设工程安全生产管理条例》第四十九条规定，施工单位应当根据建设工程施工的特点、范围，对施工现场易发生重大事故的部位、环节进行监控，制定施工现场生产安全事故应急救援预案。实行施工总承包的，由总承包单位统一组织编制建设工程生产安全事故应急救援预案，工程总承包单位和分包单位按照应急救援预案，各自建立应急救援组织或者配备应急救援人员，配备救援器材、设备，并定期组织演练。
19. 甲建筑公司是某施工项目的施工总承包单位，乙建筑公司是其分包单位。2015年1月5日，乙建筑公司的施工项目发生了生产安全事故，应由{{c1::（）}}向负有安全生产监督管理职责的部门报告。	甲建筑公司或乙建筑公司<br>甲建筑公司<br>乙建筑公司<br>甲建筑公司和乙建筑公司	B	《建设工程安全生产管理条例》第五十条第二款规定，实行施工总承包的建设工程，由总承包单位负责上报事故。
20. 某总承包单位将工程主体结构施工分包给具有相应资质的分包单位。该工程施工过程中，分包单位发生了安全生产事故。关于双方责任的说法，错误的是{{c1::（）}}。	分包单位只承担民事赔偿责任<br>总承包单位应对本工程施工现场的安全生产负总责<br>总承包与分包单位就该安全事故承担连带责任<br>如果发生的安全事故情节特别严重，构成犯罪的，应当追究总承包单位主要责任人责任	A	《建设工程安全生产管理条例》第二十四条规定，建设工程实行施工总承包的，由总承包单位对施工现场的安全生产负总责。总承包单位和分包单位对分包工程的安全生产承担连带责任。分包单位应当服从总承包单位的安全生产管理，分包单位不服从管理导致生产安全事故的，由分包单位承担主要责任。安全事故情节特别严重的，而且构成犯罪的，要追究总承包单位主要负责人责任。
21. 根据《建设工程安全生产管理条例》，下列违反施工总承包单位与分包单位安全责任划分的规定的是{{c1::（）}}。	总承包单位应当自行完成建设工程主体结构的施工<br>总承包单位和分包单位对分包工程的安全生产承担连带责任<br>分包单位应当接受总承包单位的安全生产管理<br>分包单位不服从管理导致生产安全事故的，由分包单位承担全部责任	D	D项，《建设工程安全生产管理条例》第二十四条第四款规定，分包单位应当服从总承包单位的安全生产管理，分包单位不服从管理导致生产安全事故的，由分包单位承担主要责任。
22. 王某发现吊装预制构件欲落，拒绝继续作业并迅速躲避。王某的行为是行使法律赋予的{{c1::（）}}。	正当防卫权<br>紧急避险权<br>拒绝权<br>知情权	B	安全生产中的从业人员具有紧急避险权。《安全生产法》第五十二条规定，从业人员发现直接危及人身安全的紧急情况时，有权停止作业或者在采取可能的应急措施后撤离作业场所。
23. 根据《安全生产法》的规定，下列关于工会维权的说法不正确的是{{c1::（）}}。	工会发现生产经营单位违章指挥、强令冒险作业或者发现事故隐患时，有权提出解决的建议<br>工会有权依法参加事故调查，但无权要求追究有关人员的责任<br>生产经营单位制定或者修改有关安全生产的规章制度，应当听取工会的意见<br>工会依法组织职工参加本单位安全生产工作的民主管理和民主监督，维护职工的合法权益	B	B项，工会对生产经营单位违反安全生产法律、法规，侵犯从业人员合法权益的行为，有权要求纠正。工会有权依法参加事故调查，向有关部门提出处理意见，并要求追究有关人员的责任。
24. 某煤矿工地上发生了安全生产事故，造成9人死亡，20人重伤。则下列行为违反了《安全生产法》规定的是{{c1::（）}}。	现场操作人员向项目经理报告时说有人死亡<br>在事故发生时，工人甲没有顾及施工机具的安全，迅速逃到了安全地带<br>工人乙事先发现了安全事故的隐患，但是没有向安全生产管理人员报告<br>工人丙发现了安全事故的隐患后拒绝进入危险区域施工	C	《安全生产法》第五十六条规定，从业人员发现事故隐患或者其他不安全因素，应当立即向现场安全生产管理人员或者本单位负责人报告；接到报告的人员应当及时予以处理。安全事故的发生通常都是由事故隐患或者其他不安全因素所造成的。所以，作业人员一旦发现事故隐患或者其他不安全因素，应当立即报告，以便及时采取措施，防患于未然。
25. 下列人员中，不属于建筑施工企业特种作业人员的是{{c1::（）}}。	电工<br>架子工<br>钢筋工<br>起重信号工	C	住房和城乡建设部《建筑施工特种作业人员管理规定》规定，建筑施工特种作业包括：①建筑电工；②建筑架子工；③建筑起重信号司索工；④建筑起重机械司机；⑤建筑起重机械安装拆卸工；⑥高处作业吊篮安装拆卸工；⑦经省级以上人民政府建设主管部门认定的其他特种作业。
26. 根据《安全生产法》及相关规定，下列关于施工单位的安全生产教育培训的说法错误的是{{c1::（）}}。	生产经营单位使用被派遣劳动者的，应当对被派遣劳动者进行岗位安全操作规程和安全操作技能的教育和培训<br>劳务派遣单位应当对被派遣劳动者进行必要的安全生产教育和培训<br>从业人员应当在上岗3个月内经安全生产教育和培训合格，否则不得继续从业<br>生产经营单位应当建立安全生产教育和培训档案，如实记录安全生产教育和培训的时间、内容、参加人员以及考核结果等情况	C	C项，《安全生产法》规定，生产经营单位应当对从业人员进行安全生产教育和培训，保证从业人员具备必要的安全生产知识，熟悉有关的安全生产规章制度和安全操作规程，掌握本岗位的安全操作技能，了解事故应急处理措施，知悉自身在安全生产方面的权利和义务。未经安全生产教育和培训合格的从业人员，不得上岗作业。
27. 根据《安全生产法》的规定，下列各项中，可对生产经营单位处以5万元以下罚款的不包括{{c1::（）}}。	未将事故隐患排查治理情况如实记录或者未向从业人员通报的<br>未按照规定对从业人员、被派遣劳动者、实习学生进行安全生产教育和培训，或者未按照规定如实告知有关的安全生产事项的<br>建筑施工、道路运输单位的主要负责人和安全生产管理人员未按照规定经考核合格，逾期未改正的<br>两个以上生产经营单位在同一作业区域内进行可能危及对方安全生产的生产经营活动，未签订安全生产管理协议或者未指定专职安全生产管理人员进行安全检查与协调的	C	ABC三项，《安全生产法》规定，生产经营单位有下列行为之一的，责令限期改正，可以处5万元以下的罚款；逾期未改正的，责令停产停业整顿，并处5万元以上10万元以下的罚款，对其直接负责的主管人员和其他直接责任人员处1万元以上2万元以下的罚款：①未按照规定设置安全生产管理机构或者配备安全生产管理人员的；②建筑施工、道路运输单位的主要负责人和安全生产管理人员未按照规定经考核合格的；③未按照规定对从业人员、被派遣劳动者、实习学生进行安全生产教育和培训，或者未按照规定如实告知有关的安全生产事项的；④未如实记录安全生产教育和培训情况的；⑤未将事故隐患排查治理情况如实记录或者未向从业人员通报的；⑥未按照规定制定生产安全事故应急救援预案或者未定期组织演练的；⑦特种作业人员未按照规定经专门的安全作业培训并取得相应资格，上岗作业的。<br/>D项，两个以上生产经营单位在同一作业区域内进行可能危及对方安全生产的生产经营活动，未签订安全生产管理协议或者未指定专职安全生产管理人员进行安全检查与协调的，责令限期改正，可以处5万元以下的罚款，对其直接负责的主管人员和其他直接责任人员可以处1万元以下的罚款；逾期未改正的，责令停产停业。
