1. 根据《建筑业企业资质管理规定》，关于施工企业资质证书的说法，正确的是{{c1::（）}}。[2017年真题]	变更注册后，注册有效期重新计算<br>因变更注册申报不及时导致工程项目出现损失的，由注册建造师承担责任<br>变更注册只能由原聘用企业申请<br>申请变更注册应当提交工作调动证明	D	A项，《注册建造师管理规定》中规定，在注册有效期内，注册建造师变更执业单位，应当与原聘用单位解除劳动关系，并按照规定办理变更注册手续，变更注册后仍延续原注册有效期。B项，因变更注册申报不及时影响注册建造师执业、导致工程项目出现损失的，由注册建造师所在聘用企业承担责任，并作为不良行为记入企业信用档案。C项，注册建造师变更聘用企业的，应当在与新聘用企业签订聘用合同后的1个月内，通过新聘用企业申请办理变更手续。
2. 某建设工程施工招标，甲公司中招后将其转包给不具有相应资质等级的乙公司，乙施工过程不符合规定的质量标准，给建设单位造成损失。关于向建设单位承担赔偿责任的说法，正确的是{{c1::（）}}。[2017年真题]	注册建造师不得同时担任两个及以上建设工程施工项目负责人，项目均为小型工程施工项目的除外<br>注册建造师担任施工项目负责人期间，经受聘企业同意，可以变更注册至另一企业<br>发包人与注册建造师受聘企业已解除承包合同的，办理书面交接手续后可以更换施工项目负责人<br>因非承包人原因致使工程项目停工超过120日，注册建造师可同时担任另一工程施工项目负责人	C	A项，注册建造师不得同时担任两个及以上建设工程施工项目负责人，与项目规模无关；B项，注册建造师担任施工项目负责人，在其承建的建设工程项目竣工验收或移交项目手续办结前，不得变更注册至另一企业；D项，因非承包人原因致使工程项目停工超过120日，注册建造师在建设单位同意情况下可同时担任另一工程施工项目负责人。
3. 下列承揽工程的情形中，符合工程承包管理相关规定的是{{c1::（）}}。［2013年真题］	延续有效<br>注销注册或变更注册<br>被吊销<br>被撤销	B	根据《注册建造师执业管理办法（试行）》第十九条第一款规定，聘用企业与注册建造师解除劳动关系的，应当及时申请办理注销注册或变更注册。聘用企业与注册建造师解除劳动合同关系后无故不办理注销注册或变更注册的，注册建造师可向省级建设主管部门申请注销注册证书和执业印章。
4. 根据工程承包相关法律规定，建筑业企业{{c1::（）}}承揽工程。［2010年真题］	建造师原注册单位<br>建设主管部门<br>项目经理本人<br>施工企业	D	因变更注册申报不及时影响注册建造师执业、导致工程项目出现损失的，由注册建造师所在聘用企业承担责任，并作为不良行为记入企业信用档案。
5. 按照《建筑法》规定，以下说法正确的是{{c1::（）}}。［2009年真题］	两个项目的发包人是同一单位<br>因发包人原因导致停工超过3个月<br>合同约定的工程验收合格，正在办理工程结算<br>建造师同时具有两个专业的执业资格	C	注册建造师不得同时担任两个及以上建设工程施工项目负责人。发生下列情形之一的除外：①同一工程相邻分段发包或分期施工的；②合同约定的工程验收合格的；③因非承包方原因致使工程项目停工超过120天（含），经建设单位同意的。
6. 根据《建筑业企业资质管理规定》，施工企业隐瞒相关情况或提供虚假材料申请建筑业企业资质的，不予受理并给予警告，申请人在{{c1::（）}}内不得再次申请。[2015年真题]	登记<br>注册<br>备案<br>所在单位的考核合格	B	《建造师执业资格制度暂行规定》中规定，建造师经注册后，有权以建造师名义担任建设工程项目施工的项目经理及从事其他施工活动的管理。
7. 关于施工企业违法行为应承担法律责任的说法，正确的是{{c1::（）}}。[2015年真题]	1<br>2<br>3<br>4	C	建造师的注册分为初始注册、延续注册、变更注册和增项注册四类。初始注册证书与执业印章有效期为3年。延续注册的，注册证书与执业印章有效期也为3年。变更注册的，变更注册后的注册证书与执业印章仍延续原注册有效期。
8. 某建设工程项目，甲公司中标后将其转包给不具有相应资质等级的乙公司，乙公司施工工程不符合规定质量标准，给建设单位造成损失，下列说法中，正确的是{{c1::（）}}。[2015年真题]	施工中形成的施工管理文件，应当由注册建造师签字或盖执业印章<br>施工单位签署质量合格的文件上，必须有注册建造师的签字盖章<br>所有工程施工项目负责人必须由本专业注册建造师担任<br>大型工程项目施工负责人可以由一级或二级注册建造师担任	B	AB两项，建设工程施工活动中形成的有关工程施工管理文件，应当由注册建造师签字并加盖执业印章。施工单位签署质量合格的文件上，必须有注册建造师的签字盖章，注册建造师签章完整的工程施工管理文件方为有效。C项，大中型工程项目负责人必须由本专业注册建造师担任。D项，一级注册建造师可担任大中小型工程项目负责人，二级注册建造师可担任中小型工程项目负责人。
9. 某建设工程项目公开招标，甲公司借用乙公司资质证书承揽工程，获得中标，但甲承揽工程不符合质量标准给建设单位造成了损失。关于该合同关系的说法，正确的是{{c1::（）}}。[2014年真题]	撤销注册<br>处1万元以上3万元以下罚款<br>3年内不得再次申请注册<br>不予注册	D	《注册建造师继续教育管理暂行办法》第二十六条规定，注册建造师应按规定参加继续教育，接受培训测试，不参加继续教育或继续教育不合格的不予注册。
10. 作为企业资质的法定条件，房屋建筑工程施工总承包二级企业的净资产应不少于{{c1::（）}}。	给予警告<br>取消继续教育记录<br>处1万元以上3万元以下罚款<br>撤销注册证书	B	根据《注册建造师继续教育管理暂行办法》第二十七条的规定，对于采取弄虚作假等手段取得《注册建造师继续教育证书》的，一经发现，立即取消其继续教育记录，并记入不良信用记录，对社会公布。
11. 如果以近5年承担过的施工总承包单体工程层高来衡量企业的业绩，符合二级企业资质法定条件的已完民用建筑工程单体层高最低为{{c1::（）}}。	由省级建设行政主管部门受理，由国务院建设主管部门审批<br>由省、自治区、直辖市人民政府建设行政主管部门受理和审批，报国务院建设主管部门备案<br>由国务院建设主管部门受理，由省级建设行政主管部门审批<br>由国务院建设主管部门受理和审批，报省级建设行政主管部门备案	B	《注册建造师管理规定》第九条规定，取得二级建造师资格证书的人员申请注册，由省、自治区、直辖市人民政府建设主管部门负责受理和审批，具体审批程序由省、自治区、直辖市人民政府建设主管部门依法确定。对批准注册的，核发由国务院建设主管部门统一样式的《中华人民共和国二级建造师注册证书》和执业印章，并在核发证书后30日内送国务院建设主管部门备案。
12. 我国建筑业企业资质分为{{c1::（）}}三个序列。	3年<br>6个月<br>1年<br>2年	A	初始注册者，可自资格证书签发之日起3年内提出申请。逾期未申请者，须符合本专业继续教育的要求后方可申请初始注册。
13. 按照《建筑业企业资质管理规定》，下列关于施工企业资质类别的说法中，正确的是{{c1::（）}}。	2016年4月<br>2017年3月<br>2017年4月<br>2018年4月	B	二级建造师注册证书有效期为3年，变更注册后仍延续原注册有效期。注册有效期满需继续执业的，应当在注册有效期届满30日前，按照《注册建造师管理规定》第七条、第八条的规定申请延续注册。延续注册的，有效期为3年。本题中，赵某变更注册后有效期到2014年3月止，所以赵某延续注册后的有效期到2017年3月止。
14. 根据《建筑业企业资质管理规定》，关于我国建筑业企业资质的说法，错误的是{{c1::（）}}。	同时受聘于两个或两个以上单位的<br>被吊销注册证书，自处罚决定之日起至申请注册之日止不满2年的<br>因执业活动受到刑事处罚，刑事处罚执行完毕已满5年的<br>年龄超过60岁的	B	《注册建造师管理规定》第十五条规定，申请人有下列情形之一的，不予注册：①不具有完全民事行为能力的；②申请在两个或者两个以上单位注册的；③未达到注册建造师继续教育要求的；④受到刑事处罚，刑事处罚尚未执行完毕的；⑤因执业活动受到刑事处罚，自刑事处罚执行完毕之日起至申请注册之日止不满5年的；⑥因前项规定以外的原因受到刑事处罚，自处罚决定之日起至申请注册之日止不满3年的；⑦被吊销注册证书，自处罚决定之日起至申请注册之日止不满2年的；⑧在申请注册之日前3年内担任项目经理期间，所负责项目发生过重大质量和安全事故的；⑨申请人的聘用单位不符合注册单位要求的；⑩年龄超过65周岁的；法律、法规规定不予注册的其他情形。
15. 我国对建筑业企业的资质管理，实行{{c1::（）}}的管理模式。	甲可以向省级建设主管部门申请注销注册证书和执业印章<br>甲可以向劳动争议调解机构申请调解<br>甲可以向建设主管部门申诉<br>甲可以要求企业限期履行申请手续	A	聘用企业与注册建造师解除劳动关系的，应当及时申请办理注销注册或变更注册。聘用企业与注册建造师解除劳动合同关系后无故不办理注销注册或变更注册的，注册建造师可向省级建设主管部门申请注销注册证书和执业印章。
16. 企业首次申请或增项申请资质的，应当申请{{c1::（）}}资质。	设计<br>施工<br>监理<br>造价咨询	B	《注册建造师管理规定》规定，取得资格证书的人员应当受聘于一个具有建设工程勘察、设计、施工、监理、招标代理、造价咨询等一项或者多项资质的单位，经注册后方可从事相应的职业活动。担任施工单位项目负责人的应当受聘并注册于一个具有施工资质的企业。据此，建造师不仅可以在施工单位担任建设工程施工项目的项目经理，也可以在勘察、设计、监理、招标代理、造价咨询等单位或具有多项上述资质的单位执业。但是，如果要担任施工单位的项目负责人即项目经理，其所受聘的单位必须具有相应的施工企业资质，而不能是仅具有勘察、设计、监理等资质的其他企业。
17. 企业申请延续资质证书，应在资质证书有效期届满{{c1::（）}}前向发证机关提出申请。	发包方同意更换项目负责人<br>承包方同意更换项目负责人<br>发包方与承包方产生了合同纠纷<br>因不可抗力暂停施工	A	《注册建造师执业管理办法（试行）》第十条规定，注册建造师担任施工项目负责人期间原则上不得更换。如发生下列情形之一的，应当办理书面交接手续后更换施工项目负责人：①发包方与注册建造师受聘企业已解除承包合同的；②发包方同意更换项目负责人的；③因不可抗力等特殊情况必须更换项目负责人的。
18. 企业发生合并、分立、改制的，其资质证书{{c1::（）}}。	施工单位签署质量合格的文件上，必须有注册建造师的签字盖章<br>担任建设工程施工项目负责人的注册建造师在执业过程中，应当及时、独立完成建设工程施工管理文件签章<br>分包工程施工管理文件应当由分包企业注册建造师签章<br>注册建造师不得拒绝在文件上签字并加盖执业印章	D	D项，《注册建造师执业管理办法（试行）》第十三条第二款规定，注册建造师有权拒绝在不合格或者有弄虚作假内容的建设工程施工管理文件上签字并加盖执业印章。
19. 因企业分立而新设立的建筑业企业，其资质等级应按{{c1::（）}}。	施工单位的注册建造师，最多只能同时担任两个项目施工的负责人<br>可以从事项目总承包管理、施工管理、建设工程项目管理服务<br>经受聘单位同意，临时出借注册证书和执业印章<br>在保证执业成果质量的前提下，以建造师名义从事第二职业	B	《注册建造师管理规定》第二十六条规定，注册建造师不得有下列行为：①不履行注册建造师义务；②在执业过程中，索贿、受贿或者谋取合同约定费用外的其他利益；③在执业过程中实施商业贿赂；④签署有虚假记载等不合格的文件；⑤允许他人以自己的名义从事执业活动；⑥同时在两个或者两个以上单位受聘或者执业；⑦涂改、倒卖、出租、出借、复制或以其他形式非法转让资格证书、注册证书和执业印章；⑧超出执业范围和聘用单位业务范围内从事执业活动；⑨法律、法规、规章禁止的其他行为。
20. 关于无资质的“实际施工人”利益受到侵害时处理的说法，正确的是{{c1::（）}}。	给予警告，1年内不准再申请注册<br>撤销注册，处以罚款，3年内不准再次申请注册<br>撤销注册，没收非法所得<br>责令改正，处以违法所得3倍以下且不超过3万元的罚款	B	《注册建造师管理规定》第三十四条规定，以欺骗、贿赂等不正当手段取得注册证书的，由注册机关撤销其注册，3年内不得再次申请注册，并由县级以上地方人民政府建设主管部门处以罚款。其中没有违法所得的，处以1万元以下的罚款；有违法所得的，处以违法所得3倍以下且不超过3万元的罚款。
21. 根据我国《建筑法》的规定，资质不同的单位组成的承包联合体，应当{{c1::（）}}。	终身不予注册<br>吊销执业资格证书，5年内不予注册<br>责令停止执业3年<br>责令停止执业1年	A	《建设工程质量管理条例》规定，违反本条例规定，注册建筑师、注册结构工程师、监理工程师等注册执业人员因过错造成质量事故的，责令停止执业1年；造成重大质量事故的，吊销执业资格证书，5年以内不予注册；情节特别恶劣的，终身不予注册。
