1. 某建设工程的单价合同中，双方根据估算的工程量约定了一个合同总价，而在实际结算时原合同总价与合同各项单价乘以实际完成量之和不一致，则该工程价款结算应以{{c1::（）}}为准。[2011年真题]	签订的合同总价<br>合同中各项单价乘以实际完成的工程量之和<br>实际完成的工程量乘以重新协商的各项单价之和<br>双方重新协商确定的单价和工程量	B	当发包工程的内容和工程量一时尚不能明确、具体地予以规定时，则可以采用单价合同形式，即根据计划工程内容和估算工程量，在合同中明确每项工程内容的单位价格（如每米、每平方米或者每立方米的价格），实际支付时则根据实际完成的工程量乘以合同单价计算应付的工程款。
2. 采用单价合同招标时，对于投标书中明显的数字计算错误，业主有权利先作修改再评标，当总价和单价的计算结果不一致时，以单价为准调整总价。这体现了单价合同{{c1::（）}}的特点。[2013年真题]	工程量优先<br>总价优先<br>单价优先<br>风险均摊	C	单价合同的特点是单价优先，例如FIDIC土木工程施工合同中，业主给出的工程量清单表中的数字是参考数字，而实际工程款则按实际完成的工程量和承包商投标时所报的单价计算。虽然在投标报价、评标以及签订合同中，人们常常注重总价格，但在工程款结算中单价优先，对于投标书中明显的数字计算错误，业主有权力先作修改再评标。当总价和单价的计算结果不一致时，以单价为准调整总价。
3. 某施工承包合同采用单价合同，在签约时双方根据估算的工程量约定了一合同总价。在 实际结算时，合同总价与合同各项单价乘以实际完成工程量之和不一致，则价款结算应以{{c1::（）}}为准。[2015年真题]	签订的合同总价<br>合同中的各项单价乘以实际完成的工程量之和<br>双方重新协商确定的单价和工程量<br>实际完成的工程量乘以重新协商的各项单价之和	B	在工程实践中，采用单价合同有时也会根据估算的工程量计算一个初步的合同总价，作为投标报价和签订合同之用。但是，当上述初步的合同总价与各项单价乘以实际完成的工程量之和发生矛盾时，则肯定以后者为准，即单价优先。实际工程款的支付也将以实际完成工程量乘以合同单价进行计算。
4. 某土石方工程按混合方式计价，其中土方工程实行总价包干，包干价20万元，石方工程实行单价合同。该工程有关的工程量和价格资料如表2Z106030所示，则该工程的结算价款是{{c1::（）}}万元。[2013年真题]<br/><p style="text-align:center"><img height="109" src="http://admintk.100xuexi.com/UpLoadImage/2013-05-07/ddd639eb-b9a3-4e1e-a3a5-47fc1c261c16.png" width="594"/></p>	87.2<br>88.2<br>92.0<br>93.0	C	当发包工程的内容和工程量一时尚不能明确、具体地予以规定时，可以采用单价合同形式，即根据计划工程内容和估算工程量，在合同中明确每项工程内容的单位价格(如每米、每平方米或者每立方米的价格)，实际支付时则根据实际完成的工程量乘以合同单价计算应付的工程款。总价合同又称总价包干合同，即根据施工招标时的要求和条件，当施工内容和有关条件不发生变化时，业主付给承包商的价款总额就不发生变化。该土石方工程中，土方工程价款金额为20万元，石方工程价款金额为：240×3000=720000（元）=72（万元），所以结算价款为：20+72=92（万元）。
5. 下列施工承包合同计价方式中，在不发生重大工程变更的情况下，由承包商承担全部工程量和价格风险的合同计价方式是{{c1::（）}}。[2015年真题]	单价合同<br>变动总价合同<br>成本加酬金合同<br>固定总价合同	D	固定总价合同的价格计算是以图纸及规定、规范为基础，工程任务和内容明确，业主的要求和条件清楚，合同总价一次包死，固定不变，即不再因为环境的变化和工程量的增减而变化。在这类合同中承包商承担了全部的工作量和价格的风险，因此，承包商在报价时对一切费用的价格变动因素以及不可预见因素都做了充分估计，并将其包含在合同价格之中。
6. 下列施工承包合同形式中，承包商承担全部工程量和价格风险的是{{c1::（）}}。[2010年真题]	单价合同<br>固定总价合同<br>变动总价合同<br>成本加酬金合同	B	B项，固定总价合同的价格计算是以图纸及规定、规范为基础，工程任务和内容明确，业主的要求和条件清楚，合同总价一次包死，固定不变，即不再因环境的变化和工程量的增减而改变。在这类合同中承包商承担了全部的工作量和价格风险。A项，单价合同又分为固定单价合同和变动单价合同。在固定单价合同条件下，承包商承担一定的风险；在变动单价合同条件下，承包商承担的风险相对较小。C项，变动总价合同又称可调总价合同，是一种相对固定的价格。在合同执行过程中，通货膨胀等不可预见因素风险由业主承担，对承包商而言，其风险相对较小。D项，成本加薪酬合同也称成本补偿合同，承包商不承担任何价格变化或工程量变化的风险。
7. 在固定总价合同形式下，承包人一般应承担的风险是{{c1::（）}}。[2014年真题]	全部工程量的风险，不包括通货膨胀的风险<br>工程变更的风险，不包括工程量和通货膨胀的风险<br>全部工程量和通货膨胀的风险<br>通货膨胀的风险，不包括工程量的风险	C	采用固定总价合同，双方结算比较简单，但是由于承包商承担了较大的风险，因此报价中不可避免地要增加一笔较高的不可预见风险费。承包商的风险主要有两个方面：一是价格风险，二是工作量风险。价格风险有报价计算错误、漏报项目、物价和人工费上涨等；工作量风险有工程量计算错误、工程范围不确定、工程变更或者由于设计深度不够所造成的误差等。
8. 关于成本加酬金合同的说法，正确的是{{c1::（）}}。[2014年真题]	采用该计价方式对业主的投资控制不利<br>成本加酬金合同不适用于抢险、救灾工程<br>成本加酬金合同不宜用于项目管理合同<br>对承包商来说，成本加酬金合同比固定总价合同的风险高	A	采用成本加酬金合同，承包商不承担任何价格变化或工程量变化的风险，这些风险主要由业主承担，对业主的投资控制很不利。而承包商则往往缺乏控制成本的积极性，常常不仅不愿意控制成本，甚至还会期望提高成本以提高自己的经济效益，因此这种合同容易被那些不道德或不称职的承包商滥用，从而损害工程的整体效益。所以，应该尽量避免采用这种合同。
9. 关于成本加固定费用合同的说法正确的是{{c1::（）}}。[2011年真题]	在工程总成本一开始估计不准，可能变化不大的情况下宜采取成本加固定费用合同<br>报酬总额随工程成本的加大而增加<br>由于酬金金额固定，承包商在缩短工期方面没有积极性<br>通常在非代理型CM模式的合同中采用	A	B项，如果设计变更或增加新项目，当直接费超过原估算成本的一定比例(如10%)时，固定的报酬也要增加；C项，这种方式虽然不能鼓励承包商降低成本，但为了尽快得到酬金，承包商会尽力缩短工期；D项，在非代理型（风险型）CM模式的合同中通常采用最大成本加费用合同。
10. 某工程由于图纸、规范等准备不充分，招标方仅能制定一个估算指标，则在招标时宜采用成本加酬金合同形式中的{{c1::（）}}。[2015年真题]	成本加固定费用合同<br>成本加固定比例费用合同<br>最大成本加费用合同<br>成本加奖金合同	D	在招标时，当图纸、规范等准备不充分，不能据以确定合同价格，而仅能制定一个估算指标时可采用成本加奖金合同。奖金是根据报价书中的成本估算指标制定的，在合同中对这个估算指标规定一个底点和顶点，分别为工程成本估算的60％～75％和110％～135％。承包商在估算指标的顶点以下完成工程则可得到奖金，超过顶点则要对超出部分支付罚款。如果成本在底点之下，则可加大酬金值或酬金百分比。
12. 某地基与基础分部工程完成后，其钢筋混凝土工程实际完成的工程量是2007 m<sup>3</sup>，而投标时工程量清单中该分项的工程量是1995 m<sup>3</sup>。在这种情况下，业主应根据{{c1::（）}}计算该分项应付的工程款。	1995m3乘以合同单价<br>1995m3乘以调整后的单价<br>2007m3乘以合同单价<br>2007m3乘以调整后的单价	C	当发包工程的内容和工程量一时尚不能明确、具体地予以规定时，则可以采用单价合同形式，即根据计划工程内容和估算工程量，在合同中明确每项工程内容的单位价格（如每米、每平方米或者每立方米的价格），实际支付时则根据实际完成的工程量乘以合同单价计算应付的工程款。
13. 在某单价合同的投标报价中，若投标人的钢筋总价小于钢筋单价与数量的乘积，则业主在评标时{{c1::（）}}。	以单价为准调整总价<br>以总价为准调整单价<br>将此标作废<br>要求投标者重新报价	A	单价合同的特点是单价优先，即如果总价出现错误，以单价为准，调整总价实际工程款以及投标书中的报价表均按单价乘以数量来计算。
14. 若建设工程项目以固定单价合同形式发包，在施工过程中主要建筑材料的价格上涨了，承包商提出了调整合同单价的要求，则业主将{{c1::（）}}。	不调整合同单价<br>可以调整合同单价<br>调整涉及材料上涨的单价<br>调整涉及材料涨幅较大的单价	A	固定单价合同条件下，无论发生哪些影响价格的因素都不对单价进行调整，因而对承包商而言就存在一定的风险。
15. 对于工期较短、工程量变化幅度不会太大的项目，适于采用{{c1::（）}}。	变动总价合同<br>固定总价合同<br>固定单价合同<br>成本加酬金合同	C	单价合同分为固定单价合同和变动单价合同。固定单价合同无论发生哪些影响价格的因素都不对单价进行调整，适用于工期较短、工程量变化幅度不会太大的项目。
16. 在工程实施过程中，发生重大设计变更时也可以对合同价格进行调整，但必须{{c1::（）}}。	经监理工程师认可<br>在合同中约定<br>经双方协商一致<br>经业主同意	B	在固定总价合同中可以约定，在发生重大工程变更、累计工程变更超过一定幅度或者其他特殊条件下可以对合同价格进行调整。
17. 某项目工程设计详细，图纸完整、清楚，工程任务和范围明确，适于采用{{c1::（）}}。	固定总价合同<br>固定单价合同<br>变动单价合同<br>成本加酬金合同	A	固定总价合同适用的情况有：①工程量小、工期短，估计在施工过程中环境因素变化小，工程条件稳定并合理；②工程设计详细，图纸完整、清楚，工程任务和范围明确；③工程结构和技术简单，风险小；④投标期相对宽裕，承包商可以有充足的时间详细考察现场，复核工程量，分析招标文件，拟订施工计划；⑤合同条件中双方的权利和义务十分清楚，合同条件完备。
18. “以图纸及规定、规范为基础，按时价进行计算，得到包括全部工程任务和内容的暂定合同价格”，这是指{{c1::（）}}。	变动总价合同<br>固定总价合同<br>单价合同<br>成本加酬金合同	A	变动总价合同，又称可调总价合同，合同价格是以图纸及规定、规范为基础，按照时价进行计算，得到包括全部工程任务和内容的暂定合同价格。
19. 采用固定价格的劳务分包合同，可以调整价格的情况是{{c1::（）}}。	由于劳务分包人原因造成的返工<br>通货膨胀导致劳务价格变化<br>法律政策变化导致劳务价格变化<br>由于劳务分包人原因造成的安全事故	C	劳务报酬，可以采用固定价格或变动价格。采用固定价格，则除合同约定或法律政策变化导致劳务价格变化以外，均为一次包死，不再调整。
20. 总价合同形式的特点是{{c1::（）}}。	不存在工程量方面的风险，对合同双方都比较公平<br>承包商不承担任何价格变化或工程量变化的风险<br>可以缩短投标的时间<br>评标时易迅速确定最低报价的投标人	D	总价合同的特点有：①发包单位可以在报价竞争状态下确定项目的总造价，可以较早确定或者预测工程成本；②业主的风险较小，承包人将承担较多的风险；③评标时易于迅速确定最低报价的投标人；④在施工进度上能极大地调动承包人的积极性；⑤发包单位能更容易、更有把握地对项目进行控制；⑥必须完整而明确地规定承包人的工作；⑦必须将设计和施工方面的变化控制在最小限度内。
21. 采用成本加酬金合同形式的最大缺点是不利于工程{{c1::（）}}。	进度控制<br>质量控制<br>成本控制<br>风险管理	C	采用成本加酬金合同，承包商不承担任何价格变化或工程量变化的风险，这些风险主要由业主承担，对业主的投资控制很不利。而承包商则往往缺乏控制成本的积极性，常常不仅不愿意控制成本，甚至还会期望提高成本以提高自己的经济效益，因此这种合同容易被那些不道德或不称职的承包商滥用，从而损害工程的整体效益。所以，应该尽量避免采用这种合同。
22. 当实行施工总承包管理模式或CM模式时，业主与施工总承包管理单位或CM单位的合同一般采用{{c1::（）}}。	变动总价合同<br>固定总价合同<br>单价合同<br>成本加酬金合同	D	成本加酬金合同是指工程施工的最终合同价格将按照工程的实际成本再加上一定的酬金进行计算。当实行施工总承包管理模式或CM模式时，业主与施工总承包管理单位或CM单位的合同一般采用成本加酬金合同。
