1. 建设单位申请领取施工许可证时，建设工期超过1年的建设工程，到位资金原则上最少为工程合同价的{{c1::（）}}。[2017年真题]	20%<br>30%<br>40%<br>50%	B	《建筑工程施工许可管理办法》明确规定，建设工期不足1年的，到位资金原则上不得少于工程合同价的50%，建设工期超过1年的，到位资金原则上不得少于工程合同价的30%。
2. 根据《建筑法》，下列情形中，符合施工许可证办理和报告制度的是{{c1::（）}}。[2017年真题]	某工程因故延期开工，向发证机关报告后施工许可证自动延期<br>某工程因地震中止施工，1年后向发证机关报告<br>某工程因洪水中止施工，1个月内向发证机关报告，2个月后自行恢复施工<br>某工程因政府宏观调控停建，1个月内向发证机关报告，1年后恢复施工前报发证机关核验施工许可证	D	A项，建设单位应当自领取施工许可证之日起3个月内开工。因故不能按期开工的，应当向发证机关申请延期；延期以两次为限，每次不超过3个月。既不开工又不申请延期或者超过延期时限的，施工许可证自行废止。BCD三项，在建的建筑工程因故中止施工的，建设单位应当自中止施工之日起一个月内，向发证机关报告。并按照规定做好建筑工程的维护管理工作。建筑工程恢复施工时，应当向发证机关报告。中止施工满一年的工程恢复施工前，建设单位应当报发证机关核验施工许可证。
3. 根据《建筑法》及相关法规，建设单位应当办理施工许可证的工程是{{c1::（）}}。[2015年真题]	国务院批准开工报告的工程<br>城镇市政基础设施工程<br>建筑面积200平方米以上的农民自建低层住宅<br>工程投资额在20万元以上的工程	B	A项，《建筑法》规定，按照国务院规定的权限和程序批准开工报告的建筑工程，不再领取施工许可证。B项，《建筑工程施工许可管理办法》第二条第一款规定，在中华人民共和国境内从事各类房屋建筑及其附属设施的建造、装修装饰和与其配套的线路、管道、设备的安装，以及城镇市政基础设施工程的施工，建设单位在开工前应当依照本办法的规定，向工程所在地的县级以上地方人民政府住房城乡建设主管部门申请领取施工许可证。CD两项，《建筑工程施工许可管理办法》规定，工程投资额在30万元以下或者建筑面积在300平方米以下的建筑工程，可以不申请办理施工许可证。
4. 建筑施工企业确定后，在建筑工程开工前，建设单位应当按照国家有关规定向工程所在地县级以上人民政府建设行政主管部门申请领取{{c1::（）}}。［2009年真题］	建设用地规划许可证<br>建设工程规划许可证<br>施工许可证<br>安全生产许可证	C	《建筑法》第七条规定，建筑工程开工前，建设单位应当按照国家有关规定向工程所在地县级以上人民政府建设行政主管部门申请领取施工许可证；但是，国务院建设行政主管部门确定的限额以下的小型工程除外。按照国务院规定的权限和程序批准开工报告的建筑工程，不再领取施工许可证。
5. 建设单位在申请领取{{c1::（）}}时，应当提供建设工程有关安全施工措施的资料。［2013年真题］	建设用地规划许可证<br>建设工程规划许可证<br>房屋销售许可证<br>建设工程施工许可证	D	《建设工程安全生产管理条例》第十条第一款规定，建设单位在申请领取施工许可证时，应当提供建设工程有关安全施工措施的资料。第四十二条第一款规定，建设行政主管部门在审核发放施工许可证时，应当对建设工程是否有安全施工措施进行审查，对没有安全施工措施的，不得颁发施工许可证。
6. 根据《建筑法》，开工报告制度是指{{c1::（）}}。[2014年真题]	建设单位对施工企业开工条件的确认<br>政府主管部门的一种行政审批制度<br>监理单位对施工企业开工准备工作的确认<br>政府主管部门对施工企业开工条件的确认	B	国务院规定的开工报告制度，不同于建设监理中的开工报告工作。二者之间有着诸多不同：①性质不同。前者是政府主管部门的一种行政许可制度，后者则是建设监理过程中的监理单位对施工单位开工准备工作的认可。②主体不同。前者是建设单位向政府主管部门申报，后者则是施工单位向监理单位提出。③内容不同。前者主要是建设单位应具备的开工条件，后者则是施工单位应具备的开工条件。
7. 在城市规划区内以划拨方式提供国有土地使用权的建设工程，建设单位在办理用地批准手续前，必须先取得该工程的{{c1::（）}}。[2016年真题]	施工许可证<br>建设工程规划许可证<br>质量安全报建手续<br>建设用地规划许可证	D	根据《城乡规划法》第三十七条规定，在城市、镇规划区内以划拨方式提供国有土地使用权的建设项目，经有关部门批准、核准、备案后，建设单位应当向城市、县人民政府城乡规划主管部门提出建设用地规划许可申请，由城市、县人民政府城乡规划主管部门依据控制性详细规划核定建设用地的位置、面积、允许建设的范围，核发建设用地规划许可证。建设单位在取得建设用地规划许可证后，方可向县级以上地方人民政府土地主管部门申请用地，经县级以上人民政府审批后，由土地主管部门划拨土地。
8. 某建设工程施工合同约定，合同工期为18个月，合同价款为2000万元，根据法律某建设单位在申请领取施工许可证时，原则上到位资金最少为{{c1::（）}}万元。［2011年真题］	100<br>200<br>600<br>1000	C	《建筑工程施工许可管理办法》第四条第一款规定，建设工期不足一年的，到位资金原则上不得少于工程合同价的50%；建设工期超过一年的，到位资金原则上不得少于工程合同价的30%。则本工程原则上最少到位资金应为：2000×30%＝600（万元）。
9. 建设单位取得施工许可证后，若不能按期开工，应当向发证机关申请延期，每次延期不超过{{c1::（）}}个月。［2012年真题］	1<br>2<br>3<br>4	C	《建筑法》第九条规定，建设单位应当自领取施工许可证之日起三个月内开工。因故不能按期开工的，应当向发证机关申请延期；延期以两次为限，每次不超过三个月。既不开工又不申请延期或者超过延期时限的，施工许可证自行废止。
10. 某建设单位领取施工许可证后因故4个月未能开工，又未申请延期，该施工许可证{{c1::（）}}。[2016年真题]	自行废止<br>重新核验<br>继续有效<br>自行延期	A	根据《建筑法》第九条规定，建设单位应当自领取施工许可证之日起3个月内开工。因故不能按期开工的，应当向发证机关申请延期；延期以两次为限，每次不超过3个月。既不开工又不申请延期或者超过延期时限的，施工许可证自行废止。
11. 某建筑工程因故中止施工已满一年，在恢复施工前，建设单位已领取的施工许可证应当{{c1::（）}}。［2013年真题］	申请延期<br>自行废止<br>报发证机关核验<br>重新更换	C	建筑工程恢复施工时，建设单位应当向发证机关报告恢复施工的有关情况；中止施工满一年的，在建设工程恢复施工前，建设单位还应当报发证机关核验施工许可证。
12. 根据《建筑工程施工许可管理办法》，对于未取得施工许可证且不符合开工条件的项目责令停止施工，应对{{c1::（）}}处以罚款。[2014年真题]	勘察单位<br>建设单位和施工企业<br>设计单位<br>建设单位和监理单位	B	《建筑工程施工许可管理办法》第十二条规定，对于未取得施工许可证或者为规避办理施工许可证将工程项目分解后擅自施工的，由有管辖权的发证机关责令停止施工，限期改正，对建设单位处工程合同价款1%以上2%以下罚款；对施工单位处3万元以下罚款。
13. 根据《建筑工程施工许可管理办法》，对于未取得施工许可证擅自施工，且又不符合开工条件的，应承担的法律责任是{{c1::（）}}。[2015年真题]	责令停止施工，并对建设单位和施工单位分别处以罚款<br>责令停止施工<br>责令停止施工，并对建设单位处以罚款<br>责令停止施工，并对施工单位处以罚款	A	《建筑工程施工许可管理办法》第十二条规定，对于未取得施工许可证或者为规避办理施工许可证将工程项目分解后擅自施工的，由有管辖权的发证机关责令停止施工，限期改正，对建设单位处工程合同价款1%以上2%以下罚款；对施工单位处3万元以下罚款。
14. 按照国务院有关规定批准开工报告的建筑工程，因故不能按期开工超过{{c1::（）}}个月的，应当重新办理开工报告的批准手续。	3<br>6<br>9<br>12	B	《建筑法》第十一条规定，按照国务院有关规定批准开工报告的建筑工程，因故不能按期开工或者中止施工的，应当及时向批准机关报告情况。因故不能按期开工超过六个月的，应当重新办理开工报告的批准手续。
15. 甲公司改建办公大楼，工程投资额为500万元。该工程由乙建筑集团承建，根据《建筑法》关于施工许可证的有关规定，下列说法正确的是{{c1::（）}}。	该工程无须领取施工许可证<br>应由乙建筑集团向建设行政主管部门申请领取施工许可证<br>即使未领取施工许可证，该工程也可以开工<br>未领取施工许可证，该工程不得开工	D	《建筑工程施工许可管理办法》规定，建设单位在开工前，应依照本办法的规定，向工程所在地的县级以上人民政府住房城乡建设主管部门申请领取施工许可证。工程投资额在30万元以下或者建筑面积在300平方米以下的建筑工程，可以不申请办理施工许可证。本题中，工程投资额为500万元，必须在领取施工许可证后方可开工。
16. 甲房地产开发公司将一住宅小区工程以施工总承包方式发包给乙建筑公司，建筑公司又将其中场地平整及土方工程分包给丙土方公司。在工程开工前，应当由{{c1::（）}}按照有关规定申请领取施工许可证。	乙建筑公司<br>丙土方公司<br>甲房地产开发公司和乙建筑公司共同<br>甲房地产开发公司	D	《建筑法》第七条第一款规定，建筑工程开工前，建设单位应当按照国家有关规定向工程所在地县级以上人民政府建设行政主管部门申请领取施工许可证；但是，国务院建设行政主管部门确定的限额以下的小型工程除外。
17. 某房地产开发公司在某市老城区拟开发的一住宅小区项目涉及到拆迁，则房地产公司申领施工许可证前，{{c1::（）}}。	拆迁工作必须全部完成<br>拆迁补偿安置资金全部到位<br>拆迁工程量已完成50%<br>折迁进度符合施工要求	D	《建筑法》第八条规定，申请领取施工许可证，应当具备下列条件：①已经办理该建筑工程用地批准手续；②在城市规划区的建筑工程，已经取得规划许可证；③需要拆迁的，其拆迁进度符合施工要求；④已经确定建筑施工企业；⑤有满足施工需要的施工图纸及技术资料；⑥有保证工程质量和安全的具体措施；⑦建设资金已经落实；⑧法律、行政法规规定的其他条件。
18. 建设单位申请施工许可证时，向办证机关提供的施工图纸及技术资料应当满足{{c1::（）}}。	施工需要并通过监理单位审查<br>施工需要并按规定通过了审核<br>编制招标文件的要求<br>工程竣工验收备案的要求	B	施工图设计文件不仅要满足施工需要，还应当按照规定对其涉及公共利益、公众安全、工程建设强制性标准的内容进行审查。《建设工程质量管理条例》第十一条第二款规定，施工图设计文件未经审查批准的，不得使用。
19. 根据《建筑法》，有权对建筑工程实施强制监理的范围进行规定的机构是{{c1::（）}}。	住房和城乡建设部<br>省级建设行政主管部门<br>国家安全生产监督管理行政主管部门<br>国务院	D	《建筑法》第三十条第二款规定，国务院可以规定实行强制监理的建筑工程的范围。国务院制定的《建设工程质量管理条例》第十二条具体规定了必须实行监理的建设工程范围。
20. 根据《建筑法》，在建工程因故中止施工的，建设单位应当自中止施工之日起{{c1::（）}}内，向施工许可证颁发机关报告，并按照规定做好建筑工程的维护管理工作。	15天<br>1个月<br>2个月<br>3个月	B	《建筑法》第十条规定，在建的建筑工程因故中止施工的，建设单位应当自中止施工之日起一个月内，向发证机关报告，并按照规定做好建筑工程的维护管理工作。建筑工程恢复施工时，应当向发证机关报告；中止施工满一年的工程恢复施工前，建设单位应当报发证机关核验施工许可证。
21. 某工程按国务院规定于2015年6月1日办理了开工报告审批手续，由于周边关系协调问题一直没有开工，同年12月7日准备开工时，建设单位应当{{c1::（）}}。	向批准机关申请延续<br>报批准机关核验施工许可证<br>重新办理开工报告审批手续<br>向批准机关备案	C	对于实行开工报告制度的建设工程，《建筑法》第十一条规定，按照国务院有关规定批准开工报告的建筑工程，因故不能按期开工或者中止施工的，应当及时向批准机关报告情况。因故不能按期开工超过6个月的，应当重新办理开工报告的批准手续。本题中该建设单位不能按期开工超过6个月，故应重新办理开工报告批准手续。
22. 某工程符合法定开工条件，但因工期紧未办理施工许可证或开工报告审批手续即开始施工，对此，主管部门适当的处理为{{c1::（）}}。	责令停止施工<br>责令其改正<br>只对建设单位罚款<br>只对施工单位罚款	B	《建筑法》第六十四条规定，违反本法规定，未取得施工许可证或者开工报告未经批准擅自施工的，责令改正，对不符合开工条件的责令停止施工，可以处以罚款。
23. 规避办理施工许可证应承担的法律责任是{{c1::（）}}。	责令停产停业，对建设单位处以罚款<br>责令停止施工，对建设单位和施工单位分别处以罚款<br>对不符合开工条件的，责令停止施工，处合同价1%以上2%以下的罚款<br>对责任者追究刑事责任	B	《建筑工程施工许可管理办法》规定，对于未取得施工许可证或者为规避办理施工许可证将工程项目分解后擅自施工的，由有管辖权的发证机关责令停止施工，限期改正，对建设单位处工程价款1%以上2%以下罚款；对施工单位处3万元以下罚款。
24. 对采用虚假证明文件骗取施工许可证尚未构成犯罪的，应由发证机关{{c1::（）}}。	责令停止施工，对建设单位和施工单位分别处以罚款<br>收回施工许可证，责令停止施工，对责任单位处以罚款<br>宣布该施工许可证无效，责令停止施工，没收非法所得<br>责令停止施工，有违法所得的，处以5000元以上10000元以下的罚款	B	《建筑工程施工许可管理办法》第十三条规定，建设单位采用欺骗、贿赂等不正当手段取得施工许可证的，由原发证机关撤销施工许可证，责令停止施工，并处1万元以上3万元以下罚款；构成犯罪的，依法追究刑事责任。第十四条规定，建设单位隐瞒有关情况或者提供虚假材料申请施工许可证的，发证机关不予受理或者不予许可，并处1万元以上3万元以下罚款；构成犯罪的，依法追究刑事责任。
