1. 在承揽合同中，承揽人应承担违约责任的情形是{{c1::（）}}。[2017年真题]	承揽人发现定作人提供的图纸不合理，立即停止工作并通知定作人，因等待答复，未能如期完成工作<br>承揽人发现定作人提供的材料不合格，遂自行更换为自己确认合格的材料<br>因不可抗力造成标的物毁损<br>因定作人未按时支付报酬，承揽人拒绝交付工作成果	B	承揽合同是承揽人按照定作人的要求完成工作，交付工作成果，定作人给付报酬的合同。A项，承揽人发现定作人提供的图纸或者技术要求不合理的，在通知定作人后，因定作人怠于答复等原因造成承揽人损失的，定作人应当赔偿损失。B项，定作人提供材料的，承揽人应当对定作人提供材料及时检验，发现不符合约定时，应当及时通知定作人更换、补齐或者采取其他补救措施。承揽人不得擅自更换定作人提供的材料，不得更换不需要修理的零部件。C项，不可抗力是法定免责事由，因不可抗力造成标的物毁损，承揽人无需承担违约责任。D项，除当事人另有约定的外，定作人未向承揽人支付报酬或者材料费等价款的，承揽人对完成的工作成果享有留置权。
2. 甲公司向乙公司购进一批建材。按照合同约定为甲代办铁路托运，运往合同约定的交货地点M县。在运输过程中，甲与丙签订合同，约定将这些建材转让给丙，在M县火车站交货。由于山洪暴发，火车站在运输途中出轨，建材损毁，该损失由{{c1::（）}}。[2017年真题]	丙承担<br>甲承担<br>乙承担<br>甲与乙分担	A	出卖人出卖交由承运人运输的在途标的物，除当事人另有约定的以外，毁损、灭失的风险自合同成立时起由买受人承担。但在合同成立时出卖人知道或者应当知道标的物已经毁损、灭失却未告知买受人的，出卖人应当负担标的物毁损、灭失的风险。
3. 甲公司根据乙公司的选择，向丙公司购买了1台大型设备，出租给乙使用。乙在该设备安装完毕后，发现不能正常运行，关于该合同的说法，正确的是{{c1::（）}}。[2017年真题]	甲应当对乙承担违约责任<br>若乙破产，该大型设备属于乙的破产财产<br>乙可以基于设备质量瑕疵而直接向丙索赔<br>租赁期满，乙取得该设备的所有权	C	融资租赁合同通常的做法是，承租人要求出租人为其融资购买所需的租赁物，由出租人向出卖人支付价款，并由出卖人向承租人交付租赁物及承担瑕疵担保义务，而承租人仅向出租人支付租金而无需向出卖人承担义务。A项，出售方丙需要向乙承担违约责任；B项，租赁方破产清算，融资租赁资产不计入租赁方的资产；D项，租赁期满后，承租人可以继续租赁，也可以补全租金后拥有设备所有权。
4. 关于运输合同的说法，正确的是{{c1::（）}}。[2017年真题]	托运人违反包装规定的，承运人不得拒绝运输<br>货物在运输过程中因不可抗力灭失，已收取运费的，托运人不得要求返还<br>货物运输到达后，承运人知道收货人的，应当及时通知收货人<br>联运合同中，损失发生在同一区段的承运人向托运人承担责任	C	A项，托运人违反包装规定的，承运人可以拒绝运输。B项，货物在运输过程中因不可抗力灭失，未收取运费的，承运人不得要求支付费用；已收取运费的，托运人可以要求返还。D项，损失发生在同一区段的，与托运人订立合同的承运人和该区段的承运人承担连带责任。
5. 下列行为中不符合承揽合同特征的是{{c1::（）}}。[2014年真题]	承揽人应当以自己的设备、技术和劳力完成所承揽的工作<br>承揽合同以完成一定的工作并交付工作成果为标的<br>承揽人独立完成合同义务，不受定作人的指挥管理<br>承揽人不得将承揽的主要工作交由第三人完成	D	承揽合同具有以下法律特征：①承揽合同以完成一定的工作并交付工作成果为标的；②承揽人须以自己的设备、技术和劳力完成所承揽的工作；③承揽人工作具有独立性。
6. 关于承揽合同中解除权的说法，正确的是{{c1::（）}}。[2016年真题]	定作人可以随时解除合同，造成承揽人损失的，应当赔偿损失<br>承揽人将承揽的工作交由第三人完成的，定作人有权解除合同<br>定作人不履行协助义务的，承揽人可以解除合同<br>承揽人可以随时解除合同，造成定作人损失的，应当赔偿损失	A	AD两项，根据《合同法》第二百六十八条规定，定作人可以随时解除承揽合同，造成承揽人损失的，应当赔偿损失。B项，根据第二百五十三条规定，承揽人将其承揽的主要工作交由第三人完成的，应当就该第三人完成的工作成果向定作人负责；未经定作人同意的，定作人也可以解除合同。C项，根据第二百五十九条规定，承揽工作需要定作人协助的，定作人有协助的义务。定作人不履行协助义务致使承揽工作不能完成的，承揽人可以催告定作人在合理期限内履行义务，并可以顺延履行期限；定作人逾期不履行的，承揽人可以解除合同。
7. 关于承揽合同解除的说法，正确的是{{c1::（）}}。[2015年真题]	承揽人未经定作人同意将其承揽的主要工作交由第三人完成的，定作人可以解除合同<br>除非合同当事人双方书面约定，定作人和承揽人均不得随时解除承揽合同<br>承揽人发现定作人提供的材料不符合约定的，有权以书面通知的方式，单方解除承揽合同<br>承揽人可以随时解除承揽合同，造成定作人损失的，应当赔偿损失	A	A项，承揽人将其承揽的主要工作交由第三人完成的，应当就第三人完成的工作成果向定作人负责；未经定作人同意的，定作人可以解除合同。BD两项，定作人可以随时解除承揽合同，造成承揽人损失的，应当赔偿损失。C项，定作人不履行协助义务致使承揽工作不能完成的，承揽人可以催告定作人在合理期限内履行义务，并可以顺延履行期限；定作人逾期不履行的，承揽人可以依法解除合同。因此，承揽人发现定作人提供的材料不符合约定的，可以催告定作人在合理期限内履行义务，逾期不履行的，承揽人才可以依法解除合同。
8. 关于买卖合同中标的物毁损灭失的风险承担，如果当事人没有约定交付地点或者约定不明确，下列说法正确的是{{c1::（）}}。[2016年真题]	标的物毁损灭失的风险，在标的物交付之后由出卖人承担<br>出卖人出卖交由承运人运输的在途标的物，毁损灭失的风险自承运人将货物交付给买受人时由买受人承担<br>对于需要运输的标的物，出卖人将标的物交给第一承运人后，毁损灭失的风险由买受人承担<br>出卖人依约将标的物置于交付地点，买受人违反约定没有收取的，标的物毁损灭失的风险自出卖人将标的物置于交付地点时由买受人承担	C	A项，根据《合同法》第一百四十二条规定，标的物毁损、灭失的风险，在标的物交付之前由出卖人承担，交付之后由买受人承担，但法律另有规定或者当事人另有约定的除外。B项，第一百四十四条规定，出卖人出卖交由承运人运输的在途标的物，除当事人另有约定的以外，毁损、灭失的风险自合同成立时起由买受人承担。C项，根据第一百四十五条规定，当事人没有约定交付地点或者约定不明确，依照本法第第一百四十一条第二款第一项的规定标的物需要运输的，出卖人将标的物交付给第一承运人后，标的物毁损、灭失的风险由买受人承担。D项，根据第一百四十六条规定，出卖人按照约定或者依照本法第一百四十一条第二款第二项的规定将标的物置于交付地点，买受人违反约定没有收取的，标的物毁损、灭失的风险自违反约定之日起由买受人承担。
9. 某买卖合同约定甲向乙供货，并约定甲向承运人丙交付货物即视为甲完成交付。在货物交付运输期间，乙将该批货物转卖给丁并通知丙向丁交货，但乙和丁对于货物毁损、灭失的风险没有约定。关于本案例中货物毁损、灭失风险承担的说法，正确的是{{c1::（）}}。[2015年真题]	乙与丁的买卖合同成立时，货物毁损、灭失的风险由丁承担<br>甲向丙交付货物后，货物毁损、灭失的风险由丙承担<br>甲与乙的买卖合同成立，货物毁损、灭失的风险即由乙承担<br>丙向丁交付货物前，货物毁损、灭失的风险由乙承担	A	标的物毁损、灭失的风险，在标的物交付之前由出卖人承担，交付之后由买受人承担。出卖人出卖交由承运人运输的在途标的物，除当事人另有约定的以外，毁损、灭失的风险自合同成立时起由买受人承担。
10. 关于借款合同的说法，正确的是{{c1::（）}}。[2016年真题]	借款合同自双方当事人签字盖章之日起生效<br>借款合同为有偿合同<br>借款合同必须采用书面形式<br>自然人之间的借款合同，自贷款人提供借款时生效	D	AD两项，根据《合同法》第二百一十条规定，自然人之间的借款合同，自贷款人提供借款时生效。B项，借款合同原则上为有偿合同（有息借款），也可以是无偿合同（无息借款）。自然人之间的借款合同如果没有约定利息，贷款人主张利息的，人民法院不予支持。C项，根据第一百九十七条规定，借款合同采用书面形式，但自然人之间借款另有约定的除外。
11. 关于租赁合同特征的说法，正确的是{{c1::（）}}。[2014年真题]	租赁合同是单务合同<br>租赁合同成立以租赁物的交付为要件<br>出租方转移租赁物的所有权<br>承租人获得租赁物的使用收益权	D	租赁合同是转移租赁物使用收益权的合同，也是诺成合同和双务、有偿合同。在租赁合同中，承租人的目的是取得租赁物的使用收益权，出租人也只转让租赁物的使用收益权，而不转让其所有权；租赁合同终止时，承租人须返还租赁物。这是租赁合同区别于买卖合同的根本特征。租赁合同的成立不以租赁物的交付为要件，当事人只要依法达成协议，合同即告成立。
12. 租赁合同的出租人出卖租赁房屋前通知了承租人，此时承租人享有的权利是{{c1::（）}}。[2015年真题]	优先购买权<br>留置权<br>抗辩权<br>优先受偿权	A	出租人出卖租赁房屋的，应当在出卖之前的合理期限内通知承租人，承租人享有以同等条件优先购买的权利。租赁物在租赁期间发生所有权变动的，不影响租赁合同的效力。承租人在房屋租赁期间死亡的，与其生前共同居住的人可以按照原租赁合同租赁该房屋。生前共同居住的人不以与承租人是否有继承关系、亲属关系为限。
13. 关于融资租赁合同的说法，正确的是{{c1::（）}}。[2016年真题]	承租人破产的，租赁物属于破产财产<br>承租人享有与受领标的物有关的买受人的权利<br>出卖人不履行买卖合同义务的，由出租人行使索赔的权利<br>出租人应当履行承租人占有租赁物期间的维修义务	B	根据《合同法》第二百三十九条规定，（融资租赁合同）出租人根据承租人对出卖人、租赁物的选择订立的买卖合同，出卖人应当按照约定向承租人交付标的物，承租人享有与受领标的物有关的买受人的权利。A项，根据第二百四十二条规定，出租人享有租赁物的所有权。承租人破产的，租赁物不属于破产财产。C项，根据第二百四十条规定，出租人、出卖人、承租人可以约定，出卖人不履行买卖合同义务的，由承租人行使索赔的权利。承租人行使索赔权利的，出租人应当协助。D项，根据第二百四十七条规定，承租人应当妥善保管、使用租赁物。承租人应当履行占有租赁物期间的维修义务。
14. 货运合同的托运人未按照约定包装货物，承运人可以{{c1::（）}}。[2015年真题]	留置货物<br>要求赔偿<br>解除合同<br>拒绝运输	D	托运人应当按照约定的方式包装货物。对包装方式没有约定或者约定不明确的，适用《合同法》第一百五十六条的规定。托运人违反包装的规定的，承运人可以拒绝运输。
15. 货物在运输过程中因不可抗力灭失，则关于运费支付的说法，正确的是{{c1::（）}}。[2016年真题]	未收取运费的，承运人不得要求支付运费<br>运费由运货人承担<br>已收取运费的，托运人无权要求返还<br>运费由承运人和托运人共同承担	A	货物在运输过程中因不可抗力灭失，未收取运费的，承运人不得要求支付运费；已收取运费的，托运人可以要求返还。
16. 甲代理乙与丙铁路运输公司签订了多式联运合同，由丙和丁汽车运输公司通过铁路、公路联运方式将货物送至乙的工地。因在公路运输途中发生重大交通事故，致使货物受损，无法按期交货。关于责任承担的说法，正确的是{{c1::（）}}[2014年真题]	丙应向甲承担违约责任<br>甲只能向丁主张损失赔偿<br>丙应向乙承担违约责任<br>乙应自行承担货物损失	C	多式联运是指由两种及其以上的交通工具相互衔接、转运而共同完成的运输过程。多式联运经营人负责履行或者组织履行多式联运合同，对全程运输享有承运人的权利，承担承运人的义务。
17. 某工程项目建设过程中，发包人与机械厂签订了加工非标准的大型管道叉管的合同，并提供了制作叉管的钢模，根据《合同法》，该合同属于{{c1::（）}}合同。	委托<br>承揽<br>施工承包<br>信托	B	《合同法》规定，承揽合同是承揽人按照定作人的要求完成工作，交付工作成果，定作人给付报酬的合同。承揽包括加工、定作、修理、复制、测试、检验等工作。本题中的合同属于承揽合同。
18. 经定作人同意，承揽人将其承揽的主要工作交由第三人完成。关于责任承担的说法，正确的是{{c1::（）}}。	第三人就完成的工作成果向定作人负责<br>承揽人不再承担责任<br>承揽人与第三人按完成工作成果的比例向定作人承担责任<br>承揽人就该第三人完成的工作成果向定作人负责	D	《合同法》第二百五十三条规定，承揽人应当以自己的设备、技术和劳力,完成主要工作，但当事人另有约定的除外。承揽人将其承揽的主要工作交由第三人完成的，应当就该第三人完成的工作成果向定作人负责；未经定作人同意的，定作人也可以解除合同。
19. 定作合同对于支付报酬的期限没有约定或者约定不明，又不能达成补充协议，按照合同有关条款或者交易习惯也不能确定的，定作人应当在{{c1::（）}}支付报酬。	合同生效后<br>交付工作成果时<br>完成工作成果50%<br>完成全部工作成果前	B	定作人应当按照约定的期限支付报酬。对支付报酬的期限没有约定或者约定不明确的，可以协议补充；不能达成补充协议的，按照合同有关条款或者交易习惯确定。对于不能达成补充协议，也不能按照合同有关条款或者交易习惯确定的，定作人应当在承揽人交付工作成果时支付；工作成果部分交付的，定作人应当相应支付。
20. 根据《合同法》，关于定作人权利和义务的说法，正确的是{{c1::（）}}。	定作人有权随时解除承揽合同，造成损失的应当赔偿<br>没有约定报酬支付期限的，定作人应当先行预付<br>报酬约定不清的，定作人有权拒付<br>因定作人提供的图纸不合理导致损失的，定作人与承揽人承担连带责任	A	《合同法》第二百六十八条规定，定作人可以随时解除承揽合同，造成承揽人的损失的，应当赔偿损失。承揽人发现定作人提供的图纸或者技术要求不合理的，在通知定作人后，因定作人怠于答复等原因造成承揽人损失的，定作人应当赔偿损失。
21. 甲公司向乙公司定做一批预制板。乙开工不久，甲需要将预制板加厚，遂要求乙停止制作。关于甲权利义务的说法，正确的是{{c1::（）}}。	甲应支付相应部分报酬<br>甲不得中途要求乙停止制作<br>甲应支付全部约定报酬<br>甲不用赔偿乙的损失	A	《合同法》第二百五十八条规定，定作人中途变更承揽工作的要求，造成承揽人损失的，应当赔偿损失。定作人应当履行支付报酬的义务，工作成果部分交付的，定作人应当相应支付。本题中，甲中途变更合同内容，并要求乙停止制作，应当向乙支付相应的报酬并赔偿相应的损失。
22. 甲将自己创作的一幅画卖给乙，双方于1月2日签订了买卖合同，由于甲3月1日要用此画参加一个画展，遂在签订合同时与乙约定暂不交画，待画展结束后，于3月8日交付。则下列表述正确的是{{c1::（）}}。	甲、乙买卖合同不成立<br>甲、乙买卖合同于3月8日成立并生效<br>该画所有权发生转移<br>该画所有权尚未转移	C	AB两项，买卖合同是诺成合同，诺成合同自当事人双方意思表示一致即可成立，不以一方交付标的物为合同的成立要件。本题中，买卖合同的成立日期为签订日，即1月2日。CD两项，出卖人向买受人交付标的物的方式除了直接交付以外还有简易交付、占有改定、指示交付、拟制交付等方式。本题便应用了占有改定的方式，即买卖双方特别约定，合同生效后的标的物仍然由出卖人继续占有，但其所有权已经发生法律上的转移。因此，该画在1月2日所有权便发生了转移。
23. 出卖人将标的物的权利凭证交给买受人，以替代标的物的现实交付，该种交付方式称为{{c1::（）}}。	简易交付<br>占有改定<br>指示交付<br>拟制交付	D	出卖人应当向买受人交付标的物或者交付提取标的物的单证，并应当按照约定或者交易习惯向买受人交付提取标的物单证以外的有关单证和资料。交付的方式可以是：①现实交付。标的物由出卖人直接交付给买受人。②简易交付。标的物在订立合同之前已为买受人占有，合同生效即视为完成交付。③占有改定。买卖双方特别约定，合同生效后标的物仍然由出卖人继续占有，但其所有权已完成法律上的转移。④指示交付。合同成立时，标的物为第三人合法占有，买受人取得了返还标的物请求权。⑤拟制交付。出卖人将标的物的权利凭证（如仓单、提单）交给买受人，以代替标的物的现实交付。
24. 买卖合同中标的物的风险负担关系买卖双方当事人的利益。下列表述中错误的是{{c1::（）}}。	除非法律另有规定或者当事人另有约定外，买卖合同标的物毁损、灭失的风险，在标的物交付之前由出卖人承担，交付之后由买受人承担<br>因买受人的原因致使标的物不能按照约定的期限交付的，买受人应当自标的物交付之日起承担标的物毁损、灭失的风险<br>出卖人按照约定未交付有关标的物的单证和资料的，不影响标的物毁损、灭失风险的转移<br>因标的物质量不符合要求，致使不能实现合同目的，买受人拒绝接受标的物或者解除合同的，标的物毁损、灭失的风险由出卖人承担	B	B项，《合同法》第一百四十三条规定，因买受人的原因致使标的物不能按照约定的期限交付的，买受人应当自违反约定之日起承担标的物毁损、灭失的风险。
25. 甲、乙订立一耕牛买卖合同。双方约定于7月15日交付耕牛和牛款，但由于时值农忙，甲想再借用一个月。于是到7月15日那天，乙交付了牛款，双方约定牛归乙所有，但甲继续借用一个月。8月10日，该牛在甲的牛栏中产下一头小牛，对于该小牛的归属，甲、乙发生了争议。下列说法正确的是{{c1::（）}}。	归甲所有，因为该牛由甲占有<br>归甲、乙共同共有<br>归乙所有，因为牛已经交付<br>归甲所有，因为尽管所有权已经转移但并未交付	C	《合同法》第一百六十三条规定，标的物在交付之前产生的孳息，归出卖人所有，交付之后产生的孳息，归买受人所有。甲借用牛是在双方交付（此交付在性质上为占有改定）之后，生下的小牛属于交付之后的孳息，应该归乙所有。
26. 根据《合同法》，分期付款的买受人未支付到期价款的金额达到全部价款的{{c1::（）}}，出卖人即有权要求买受人支付全部价款或者解除合同。	1/3<br>1/2<br>1/5<br>2/3	C	《合同法》第一百六十七条规定，分期付款的买受人未支付到期价款的金额达到全部价款的五分之一的，出卖人可以要求买受人支付全部价款或者解除合同。
27. 甲因盖房急需用钱，2月4日向邻居乙提出借钱，并承诺支付一定利息。2月5日乙答复同意，2月6日双方立下字据，2月7日乙将钱交给甲。此借款合同生效日为{{c1::（）}}。	2月4日<br>2月5日<br>2月6日<br>2月7日	D	根据《合同法》第二百一十条规定，自然人之间的借款合同为实践合同，自贷款人提供借款时生效。
28. 村民甲向村民乙借款人民币4万元，甲出具的借条上写明8个月后归还，并且双方口头商定不支付利息。借款12个月后甲欲归还所借款项。双方对归还4万元本金没有异议，但对是否要偿付利息发生争议，对于这一问题，以下说法正确的是{{c1::（）}}。	从借款之日到还款之日止支付利息<br>按口头约定，不支付利息<br>从8个月期满之日起计算利息<br>双方应另行商定是否计算利息	B	《合同法》第二百一十一条第一款规定，自然人之间的借款合同对支付利息没有约定或约定不明确的，视为不支付利息。
29. 甲、乙口头约定甲承租乙的房屋25年，则以下关于该租赁的说法中正确的是{{c1::（）}}。	租赁期限为25年<br>租赁期限为20年<br>为不定期租赁<br>该租赁违背了法律的强行性规定，属于无效租赁合同	C	《合同法》第二百一十四条规定，租赁合同可以约定租赁期限，但租赁期限不得超过20年。超过20年的，超过部分无效。租赁期间届满，当事人可以续订租赁合同，但约定的租赁期限自续订之日起不得超过20年。第二百一十五条规定，租赁期限6个月以上的，应当采用书面形式。当事人未采用书面形式的，视为不定期租赁。
30. 某工程需租用钢管，双方约定租赁期限为8个月，则下列关于该租赁合同的说法，错误的是{{c1::（）}}。	应以书面方式订立<br>若以口头方式订立，则租赁期视为6个月<br>若以口头方式订立，出租人可随时解除合同<br>若以口头方式订立，承租人可随时解除合同	B	《合同法》第二百一十五条规定，租赁期限6个月以上的，应当采用书面形式。当事人未采用书面形式的，视为不定期租赁。不定期租赁合同，当事人均可以随时解除合同，但出租人应当在合理期限前通知承租人。
31. 甲企业于2015年12月1日从乙银行贷款1000万元，期限为9个月，但双方在借款合同中没有约定支付利息的期限，在依照《合同法》有关规定仍不能确定的情况下，甲企业支付利息的期限为{{c1::（）}}。	每月的最后1日支付<br>每季度的最后1日支付<br>前6个月的最后1日支付2/3的利息，借款期限届满时支付剩余的1/3利息<br>在返还借款时一并支付利息	D	借款人应当按照约定的期限支付利息，对于不能达成补充协议，也不能按照合同有关条款或者交易习惯确定的，借款期间不满一年的，应当在返还借款时一并支付；借款期间一年以上的，应当在每届满一年时支付，剩余期间不满一年的，应当在返还借款时一并支付。
32. 在融资租赁合同中，因出卖人不履行买卖合同的义务产生索赔的权利，{{c1::（）}}。	出租人可以转让给承租人<br>出租人不可以转让给承租人<br>经出卖人同意，出租人可以转让给承租人<br>在不损害出卖人利益的前提下，出租人可以转让给承租人	A	《合同法》第二百四十条规定，出租人、出卖人、承租人可以约定，出卖人不履行买卖合同义务的，由承租人行使索赔的权利。承租人行使索赔权利的，出租人应当协助。
33. 下列关于融资租赁合同的说法，错误的是{{c1::（）}}。	承租人将其自有物出卖给出租人，再通过融资租赁合同将租赁物从出租人处租回的，人民法院不应仅以承租人和出卖人系同一人为由认定不构成融资租赁法律关系<br>出卖人未在约定的交付期间内交付租赁物，经承租人或者出租人催告，在催告期满后仍未交付，承租人可拒绝受领该租赁物<br>承租人占有租赁物期间，租赁物毁损、灭失的风险由承租人承担，出租人可以要求承租人继续支付租金，但当事人另有约定或者法律另有规定的除外<br>出租人转让其在融资租赁合同项下的部分或者全部权利，受让方能够以此为由请求解除或者变更融资租赁合同	D	A项，承租人将其自有物出卖给出租人，再通过融资租赁合同将租赁物从出租人处租回的，人民法院不应仅以承租人和出卖人系同一人为由认定不构成融资租赁法律关系。B项，出卖人违反合同约定的向承租人交付标的物的义务，承租人因下列情形之一拒绝受领租赁物的，人民法院应予支持：①租赁物严重不符合约定的；②出卖人未在约定的交付期间或者合理期间内交付租赁物，经承租人或者出租人催告，在催告期满后仍未交付的。CD两项，承租人占有租赁物期间，租赁物毁损、灭失的风险由承租人承担，出租人要求承租人继续支付租金的，人民法院应予支持。但当事人另有约定或者法律另有规定的除外。出租人转让其在融资租赁合同项下的部分或者全部权利，受让方以此为由请求解除或者变更融资租赁合同的，人民法院不予支持。
34. 甲厂与乙运输公司签订货物运输合同，但货物在运输过程中因不可抗力灭失，则乙{{c1::（）}}。	可以要求甲支付运费<br>不可以要求甲支付运费<br>可要求甲支付一半运费<br>根据公平原则，可要求甲适当支付运费	B	《合同法》第三百一十四条规定，货物在运输过程中因不可抗力灭失，未收取运费的，承运人不得要求支付运费；已收取运费的，托运人可以要求返还。
35. 某商店与某运输公司签订了一份运输合同，由运输公司将一批瓷器从唐山运往北京，商店派一名押运员同行，途中停车吃饭，司机与押运员两人喝了一瓶酒，饭后继续上路，由于饮酒与劳累，司机要求押运员代其开车，押运员也没有推辞，在一转弯处，由于车速较快，不慎翻车，车上的瓷器全部毁损，对于该瓷器毁损应由{{c1::（）}}承担责任。	商店<br>商店、运输公司<br>司机与押运员<br>运输公司	D	运输合同是托运人和承运人之间订立的合同，运输公司是承运人，其未完成合同约定的运输义务，导致瓷器全部毁损，对托运人的损失应当承担违约责任。运输公司在向商店承担责任后，可以向直接责任人司机和押运员追偿。
36. 在委托合同中，受托人未经委托人同意，即将委托事务转委托给第三人，则对该第三人的行为，应由{{c1::（）}}承担责任。	受托人<br>该第三人<br>受托人和该第三人连带<br>受托人和该第三人按份	A	《合同法》第四百条规定，受托人应当亲自处理委托事务。经委托人同意，受托人可以转委托。转委托经同意的，委托人可以就委托事务直接指示转委托的第三人，受托人仅就第三人的选任及其对第三人的指示承担责任。转委托未经同意的，受托人应当对转委托的第三人的行为承担责任，但在紧急情况下受托人为维护委托人的利益需要转委托的除外。
37. 甲、乙两公司，甲给乙5000元钱，委托其代买设备一台，设备价值5000元。在代买过程中5000元钱被小偷偷走。则5000元钱的损失应由{{c1::（）}}。	甲承担<br>乙承担<br>甲乙平均分担<br>乙承担大部分，甲适当分担	A	《合同法》第四百零六条规定，无偿的委托合同，因受托人的故意或者重大过失给委托人造成损失的，委托人可以要求赔偿损失。本题中，甲乙之间是无偿的委托合同，该5000元损失不是由于受托人乙的故意或重大过失造成的，应该由甲自己承担。
