1. 下列招标情形中，属于以不合理条件限制、排斥潜在投标人或者投标人的有{{c1::（）}}。[2017年真题]	就同一招标项目向潜在投标人或者投标人提供有差别的项目信息<br>设定的资格、技术、商务条件与招标项目的具体特点和实际需要不相适应<br>限定或者指定特定的专利、商标、品牌、原产地或者供应商<br>对不同的潜在投标人或者投标人采取相同的资格审查或者评标标准<br>依法必须进行招标的项目以特定行业的业绩、奖项作为加分条件或者中标条件	A|B|C|E	招标人有下列行为之一的，属于以不合理条件限制、排斥潜在投标人或者投标人：①就同一招标项目向潜在投标人或者投标人提供有差别的项目信息；②设定的资格、技术、商务条件与招标项目的具体特点和实际需要不相适应或者与合同履行无关；③依法必须进行招标的项目以特定行政区域或者特定行业的业绩、奖项作为加分条件或者中标条件；④对潜在投标人或者投标人采取不同的资格审查或者评标标准；⑤限定或者指定特定的专利、商标、品牌、原产地或者供应商；⑥依法必须进行招标的项目非法限定潜在投标人或者投标人的所有制形式或者组织形式；⑦以其他不合理条件限制、排斥潜在投标人或者投标人。
2. 下列投标人不正当竞争的情形中，视为投标人相互串通投标的有{{c1::（）}}。[2017年真题]	不同投标人的投标文件相互混装<br>不同投标人的投标保证金从同一单位的账户转出<br>不同投标人委托同一单位办理投标事宜<br>不同投标人的投标报价呈规律性差异<br>投标人之间约定中标人	A|B|C|D	有下列情形之一的，视为投标人相互串通投标：①不同投标人的投标文件由同一单位或者个人编制；②不同投标人委托同一单位或者个人办理投标事宜；③不同投标人的投标文件载明的项目管理成员为同一人；④不同投标人的投标文件异常一致或者投标报价呈规律性差异；⑤不同投标人的投标文件相互混装；⑥不同投标人的投标保证金从同一单位或者个人的账户转出。E项属于投标人相互串通投标的情形。
3. 根据《工程建设项目招标范围和规模标准规定》，关系社会公共利益、公众安全的基础设施项目的范围包括{{c1::（）}}。[2014年真题]	防洪、灌溉、排涝、引（供）水、滩涂治理等水利项目<br>垃圾处理、地下管道、公共停车场等城市设施项目<br>邮政、电信枢纽、通信、信息网络等邮电通讯项目<br>供水、供电、供气、供热等市政工程项目<br>生态环境保护项目	A|B|C|E	根据《工程建设项目招标范围和规模标准规定》，关系社会公共利益、公众安全的基础设施项目的范围包括：①煤炭、石油、天然气、电力、新能源等能源项目；②铁路、公路、管道、水运、航空以及其他交通运输业等交通运输项目；③邮政、电信枢纽、通信、信息网络等邮电通讯项目；④防洪、灌溉、排涝、引（供）水、滩涂治理、水土保持、水利枢纽等水利项目；⑤道路、桥梁、地铁和轻轨交通、污水排放及处理、垃圾处理、地下管道、公共停车场等城市设施项目；⑥生态环境保护项目；⑦其他基础设施项目。
4. 根据《工程建设项目招标范围和规模标准规定》，必须招标范围内的各类工程建设项目，达到下列标准之一必须进行招标的有{{c1::（）}}。[2016年真题]	材料采购的单项合同估算价为人民币80万<br>施工单项合同估算价为人民币300万<br>重要设备采购的单项合同估算价为人民币150万<br>监理服务采购的单项合同估算价为人民币60万<br>项目总投资额为人民币3500万	B|C|D|E	根据《工程建设项目招标范围和规模标准规定》第七条的规定，必须招标范围内的各类工程建设项目，达到下列标准之一的，必须进行招标：①施工单项合同估算价在人民币200万元以上的；②重要设备、材料等货物的采购，单项合同估算价在人民币100万元以上的；③勘察、设计、监理等服务的采购，单项合同估算价在人民币50万元以上的；④单项合同估算价低于第①、②、③项规定的标准，但项目总投资额在人民币3000万元以上的。
5. 依法必须进行施工招标的工程建设项目，可以采用邀请招标的情形有{{c1::（）}}。[2015年真题]	项目受自然地域环境限制，只有少数潜在投标人可供选择<br>施工主要技术采用不可替代的专利或者专有技术<br>采用公开招标方式的费用占项目合同金额的比例过大<br>涉及国家安全、国家秘密或者抢险救灾，适宜招标但不宜公开招标<br>在建工程追加附属小型工程或者主体加层工作	A|C|D	《工程建设项目施工招标投标办法》第十一条规定，依法必须进行公开招标的项目，有下列情形之一的，可以邀请招标：①项目技术复杂或有特殊要求，或者受自然地域环境限制，只有少量潜在投标人可供选择；②涉及国家安全、国家秘密或者抢险救灾，适宜招标但不宜公开招标；③采用公开招标方式的费用占项目合同金额的比例过大。
6. 根据《招标投标法实施条例》，按照国家有关规定需要履行项目审批、核准手续的依法必须进行招标的项目，其{{c1::（）}}应当报项目审批、核准部门审批、核准。[2014年真题]	招标范围<br>招标文件<br>招标方式<br>招标组织形式<br>招标代理机构	A|C|D	《招标投标法实施条例》规定，按照国家有关规定需要履行项目审批、核准手续的依法必须进行招标的项目，其招标范围、招标方式、招标组织形式应当报项目审批、核准部门审批，核准。项目审批、核准部门应当及时将审批、核准确定的招标范围、招标方式、招标组织形式通报有关行政监督部门。
7. 下列投标人投标的情形中，评标委员会应当否决的有{{c1::（）}}。[2017年真题]	投标人主动提出了对投标文件的澄清、修改<br>联合体未提交共同投标协议<br>投标报价高于招标文件设定的最高投标限价<br>投标文件未经投标人盖章和单位负责人签字<br>投标文件未对招标文件的实质性要求和条件作出响应	B|C|D|E	有下列情形之一的，评标委员会应当否决其投标：①投标文件未经投标单位盖章和单位负责人签字；②投标联合体没有提交共同投标协议；③投标人不符合国家或者招标文件规定的资格条件；④同一投标人提交两个以上不同的投标文件或者投标报价，但招标文件要求提交备选投标的除外；⑤投标报价低于成本或者高于招标文件设定的最高投标限价；⑥投标文件没有对招标文件的实质性要求和条件作出响应；⑦投标人有串通投标、弄虚作假、行贿等违法行为。
8. 下列情形中，评标委员会应当否决的投标有{{c1::（）}}。[2016年真题]	投标报价低于成本<br>投标文件未按招标文件要求进行密封<br>投标联合体没有提交共同投标协议<br>投标报价高于招标文件设定的最高投标限价<br>投标文件未经投标人负责人签字，也未经投标人盖章	A|C|D|E	根据《招标投标法实施条例》第五十一条规定，有下列情形之一的，评标委员会应当否决其投标：①投标文件未经投标单位盖章和单位负责人签字；②投标联合体没有提交共同投标协议；③投标人不符合国家或者招标文件规定的资格条件；④同一投标人提交两个以上不同的投标文件或者投标报价，但招标文件要求提交备选投标的除外；⑤投标报价低于成本或者高于招标文件设定的最高投标限价；⑥投标文件没有对招标文件的实质性要求和条件作出响应；⑦投标人有串通投标、弄虚作假、行贿等违法行为。
9. 关于投标人的说法，正确的有{{c1::（）}}。[2015年真题]	投标人发生合并、分立、破产等重大变化的，其投标无效<br>投标人参加依法必须进行招标的项目投标，不受地区或者部门的限制<br>存在控股关系的不同单位不得参加同一招标项目的投标<br>单位负责人为同一人的不同单位参加同一标段投标的，相关投标无效<br>两个以上法人或者其他组织可以组成一个联合体投标	B|C|D|E	A项，投标人发生合并、分立、破产等重大变化的，应当及时书面告知招标人。投标人不再具备资格预审文件、招标文件规定的资格条件或者其投标影响招标公正性的，其投标无效。B项，《招标投标法》规定，依法必须进行招标的项目，其招标投标活动不受地区或者部门的限制。《招标投标法实施条例》规定，与招标人存在利害关系可能影响招标公正性的法人、其他组织或者个人，不得参加投标。单位负责人为同一人或者存在控股、管理关系的不同单位，不得参加同一标段投标或者未划分标段的同一招标项目投标。违反以上规定的，相关投标均无效。E项，两个以上法人或者其他组织可以组成一个联合体，以一个投标人的身份共同投标。
10. 在建设工程招投标活动中，关于联合体投标的说法，正确的有{{c1::（）}}。[2015年真题]	联合体各方在同一招标项目中，既可以联合体名义投标，又可以自己名义投标<br>两个以上的个人可以组成联合体<br>招标人可以强制投标人组成联合体<br>在资格预审前，联合体可以增加成员<br>联合体各方就中标项目承担连带责任	D|E	《招标投标法》规定，两个以上法人或者其他组织可以组成一个联合体，以一个投标人的身份共同投标。联合体中标的，联合体各方应当共同与招标人签订合同，就中标项目向招标人承担连带责任。招标人不得强制投标人组成联合体共同投标。《招标投标法实施条例》规定，招标人接受联合体投标并进行资格预审的，联合体应当在提交资格预审申请文件前组成。资格预审后联合体增减、更换成员的，其投标无效。联合体各方在同一招标项目中以自己名义单独投标或者参加其他联合体投标的，相关投标均无效。
11. 根据《〈标准施工招标资格预审文件〉和〈标准施工招标文件〉暂行规定》，下列文件属于投标文件内容的有{{c1::（）}}。[2016年真题]	投标函及其附录<br>施工组织设计<br>项目管理机构<br>法定代表人身份证明<br>投标邀请书	A|B|C|D	根据《〈标准施工招标资格预审文件〉和〈标准施工招标文件〉暂行规定》，投标文件应包括下列内容：①投标函及投标函附录；②法定代表人身份证明或附有法定代表人身份证明的授权委托书；③联合体协议书；④投标保证金；⑤已标价工程量清单；⑥施工组织设计；⑦项目管理机构；⑧拟分包项目情况表；⑨资格审查资料；⑩投标人须知前附表规定的其他材料。但是，投标人须知前附表规定不接受联合体投标的，或投标人没有组成联合体的，投标文件不包括联合体协议书。
12. 根据国家发展和改革委员会等9部门联合颁布的《标准施工招标文件》，投标文件应当包括{{c1::（）}}。[2014年真题]	招标管理机构<br>已标价工程量清单<br>拟转包项目情况表<br>资格审查资料<br>施工组织设计	B|D|E	2013年3月国家发展和改革委员会、财政部、住房和城乡建设部等9部门经修改后发布的《〈标准施工招标资格预审文件〉和〈标准施工招标文件〉暂行规定》中明确规定，投标文件应包括下列内容：①投标函及投标函附录；②法定代表人身份证明或附有法定代表人身份证明的授权委托书；③联合体协议书；④投标保证金；⑤已标价工程量清单；⑥施工组织设计；⑦项目管理机构；⑧拟分包项目情况表；⑨资格审查资料；⑩投标人须知前附表规定的其他材料。但是，投标人须知前附表规定不接受联合体投标的，或投标人没有组成联合体的，投标文件不包括联合体协议书。
13. 关于投标保证金的说法，正确的有{{c1::（）}}。[2016年真题]	两阶段招标中要求提交投标保证金的，应在第一阶段提出<br>投标保证金不得超过招标项目估算价的2%<br>投标保证金有效期应当与投标有效期一致<br>招标人应当在中标通知书发出后5日内退还中标人的投标保证金<br>未中标的投标人的投标保证金及利息，招标人应当在签约后5日内退还	B|C|E	A项，根据《招标投标法实施条例》第三十条第四款规定，招标人要求投标人提交投标保证金的，应当在第二阶段提出。BC两项，根据第二十六条规定，招标人在招标文件中要求投标人提交投标保证金的，投标保证金不得超过招标项目估算价的2%。投标保证金有效期应当与投标有效期一致。DE两项，根据第五十七条第二款规定，招标人最迟应当在书面合同签订后5日内向中标人和未中标的投标人退还投标保证金及银行同期存款利息。
14. 某工程项目招标投标出现的下列情形中，应当视为投标人互相串通投标的有{{c1::（）}}。[2016年真题]	两份投标文件载明的项目经理均为李某<br>两份投标文件的投标报价呈规律性差异<br>投标人使用伪造的许可证<br>两个投标人均委托某咨询单位办理投标事宜<br>投标人提供虚假的财务状况或业绩	A|B|D	根据《招标投标法实施条例》第四十条规定，有下列情形之一的，视为投标人相互串通投标：①不同投标人的投标文件由同一单位或者个人编制；②不同投标人委托同一单位或者个人办理投标事宜；③不同投标人的投标文件载明的项目管理成员为同一人；④不同投标人的投标文件异常一致或者投标报价呈规律性差异；⑤不同投标人的投标文件相互混装；⑥不同投标人的投标保证金从同一单位或者个人的账户转出。
15. 下列建设工程招标投标行为中，属于投标人不正当竞争行为的有{{c1::（）}}。[2014年真题]	投标人相互串通投标<br>投标人与招标人串通投标<br>招标人操纵中标<br>投标人以他人名义投标<br>投标人以高于市场定价的报价竞标	A|B|D	在建设工程招标投标活动中，投标人的不正当竞争行为主要有：投标人相互串通投标、招标人与投标人串通投标、投标人以行贿手段谋取中标、投标人以低于成本的报价竞标、投标人以他人名义投标或者以其他方式弄虚作假骗取中标。
16. 招标人在发出中标通知书前，由评标委员会对中标候选人进行再次审查确认的情形有{{c1::（）}}。[2015年真题]	中标候选人财务状况发生较大变化，可能影响其履约能力<br>中标候选人未缴纳履约保证金<br>中标候选人放弃中标<br>中标候选人存在违法行为，可能影响其履约能力<br>中标候选人经营发生较大变化，可能影响其履约能力	A|D|E	中标候选人的经营、财务状况发生较大变化或者存在违法行为，招标人认为可能影响其履约能力的，应当在发出中标通知书前由原评标委员会按照招标文件规定的标准和方法审查确认。
17. 下列行为中，属于招标人违法行为的有{{c1::（）}}。[2015年真题]	招标人与投标人就投标方案进行谈判的<br>招标人发出中标通知书后无正当理由改变中标结果的<br>招标人按规定的时间和程序对已发出的招标文件进行修改的<br>招标人在合同订立时向中标人提出附加条件的<br>招标人按规定的时间和程序对已发出的资格预审文件进行修改的	A|B|D	《招标投标法实施条例》规定，招标人有下列情形之一的，由有关行政监督部门责令改正，可以处10万元以下的罚款：①依法应当公开招标而采用邀请招标；②招标文件、资格预审文件的发售、澄清、修改的时限，或者确定的提交资格预审申请文件、投标文件的时限不符合招标投标法和本条例规定；③接受未通过资格预审的单位或者个人参加投标；④接受应当拒收的投标文件。依法必须进行招标的项目的招标人有下列情形之一的，由有关行政监督部门责令改正，可以处中标项目金额10‰以下的罚款；给他人造成损失的，依法承担赔偿责任；对单位直接负责的主管人员和其他直接责任人员依法给予处分：①无正当理由不发出中标通知书；②不按照规定确定中标人；③中标通知书发出后无正当理由改变中标结果；④无正当理由不与中标人订立合同；⑤在订立合同时向中标人提出附加条件。
18. 下列投标行为中，属于弄虚作假骗取中标的有{{c1::（）}}。[2014年真题]	使用伪造、变造的许可证件<br>提供虚假的财务状况或者业绩<br>提供虚假的信用状况<br>提供虚假的项目负责人劳动关系证明<br>不同投标人的投标文件相互混装	A|B|C|D	《招标投标法》规定，投标人不得以他人名义投标或者以其他方式弄虚作假，骗取中标。《招标投标法实施条例》规定，使用通过受让或者租借等方式获取的资格、资质证书投标的，属于《招标投标法》第三十三条规定的以他人名义投标。投标人有下列情形之一的，属于《招标投标法》第三十三条规定的以其他方式弄虚作假的行为：①使用伪造、变造的许可证件；②提供虚假的财务状况或者业绩；③提供虚假的项目负责人或者主要技术人员简历、劳动关系证明；④提供虚假的信用状况；⑤其他弄虚作假的行为。E项属于投标人相互串通投标。
19. 根据《招标投标法》和《招标投标法实施条例》，关于招标项目的说法，正确的有{{c1::（）}}。[2014年真题]	招标人不可以授权评标委员会直接确定中标人<br>评标委员会成员对其评审意见承担个人责任<br>履约保证金不得超过中标合同金额的10%<br>国有资金控股的依法必须进行招标的项目，排名第一的中标候选人为中标人<br>招标人可以与投标人就投标价格、投标方案等实质性内容进行谈判	B|C|D	A项，《招标投标法》规定，招标人根据评标委员会提出的书面评标报告和推荐的中标候选人确定中标人。招标人也可以授权评标委员会直接确定中标人。E项，在确定中标人前，招标人不得与投标人就投标价格、投标方案等实质性内容进行谈判。
20. 依法必须进行招标的项目的招标投标活动违反法律规定，对中标结果造成实质性影响，且不能采取补救措施予以纠正的，应{{c1::（）}}。[2014年真题]	认定招标、投标、中标无效<br>依法重新招标<br>依法重新评标<br>由行政监督部门接管剩余招标投标工作<br>依法禁止就该项目再次招标	A|B|C	《招标投标法实施条例》规定，依法必须进行招标的项目的招标投标活动违反招标投标法和本条例的规定，对中标结果造成实质性影响，且不能采取补救措施予以纠正的，招标、投标、中标无效，应当依法重新招标或者评标。
21. 下列国家融资项目必须进行招标的有{{c1::（）}}。	使用国家发行债券所筹资金的项目<br>使用国家对外借款或者担保所筹资金的项目<br>使用国家政策性贷款的项目<br>国家授权投资主体融资的项目<br>个人捐助援建项目	A|B|C|D	根据《工程建设项目招标范围和规模标准规定》第五条的规定，国家融资项目的范围包括：①使用国家发行债券所筹资金的项目；②使用国家对外借款或者担保所筹资金的项目；③使用国家政策性贷款的项目；④国家授权投资主体融资的项目；⑤国家特许的融资项目。
22. 某市城建学院计划斥资4000万元兴建教学主楼，则下列关于工程项目招投标的说法不正确的有{{c1::（）}}。	学院可以自行确定承包单位，没必要进行招投标<br>必须委托招标代理机构进行招投标确定承包单位<br>该学院可以自行办理招标事宜，没必要向任何部门备案<br>该学院可以自行办理招标事宜，但应当向有关行政监督部门备案<br>可以委托招标代理机构进行招标投标确定承包单位	A|B|C	A项，城建学院项目属于关系社会公共利益的公用事业项目，且项目总投资超过3000万元，所以该项目必须进行招标；BC两项，《招标投标法》第十二条规定，依法必须进行招标的项目，招标人自行办理招标事宜的，应当向有关行政监督部门备案。
23. 下列有权对从事工程建设项目招标代理业务的招标代理机构资格进行认定的有{{c1::（）}}。	国务院建设行政主管部门<br>省级人民政府<br>县级以上行政主管部门<br>省级人民政府建设行政主管部门<br>市级政府人民	A|D	从事工程建设项目招标代理业务的招标代理机构，其资格由国务院或者省、自治区、直辖市人民政府的建设行政主管部门认定。
24. 《招标投标法实施条例》规定，招标人发售资格预审文件、招标文件收取的费用应当包括{{c1::（）}}。	补偿印刷的成本支出<br>招标文件编制的人工成本支出<br>邮寄的成本支出<br>必要的利润<br>图纸的打印成本支出	A|C	《招标投标法实施条例》规定，招标人应当按照资格预审公告、招标公告或者投标邀请书规定的时间、地点发售资格预审文件或者招标文件。资格预审文件或者招标文件的发售期不得少于5日。招标人发售资格预审文件、招标文件收取的费用应当限于补偿印刷、邮寄的成本支出，不得以营利为目的。
25. 下列关于招投标程序的说法，正确的有{{c1::（）}}。	开标在投标截止日后进行<br>招标人在投标截止日前收到的所有投标文件，开标时都应当当众予以拆封、宣读<br>评标应当在严格保密的情况下进行<br>评标委员会经评审，认为所有投标都不符合招标文件要求的，可以否决所有投标<br>招标人仅向中标人发出中标通知书，不必通知未中标的投标人	B|C|D	A项，开标应当在招标文件确定的提交投标文件截止时间的同一时间公开进行；E项，中标人确定后，招标人应当向中标人发出中标通知书，并同时将中标结果通知所有未中标的投标人。
26. 根据《招标投标法》的规定，下列说法不符合开标程序的有{{c1::（）}}。	开标应当在招标文件确定的提交投标文件截止时间的同一时间公开<br>开标由招标人主持，邀请中标人参加<br>在招标文件规定的开标时间前收到的所有投标文件，开标时都应当当众予以拆封、宣读<br>开标地点应当为招标人指定的地点<br>开标过程应当记录，并存档备查	B|D	B项，开标由招标人主持，邀请所有投标人参加；D项，开标地点应当为招标文件中预先确定的地点。
27. 开标时检查投标文件密封情况，应当由{{c1::（）}}进行。	评标委员会<br>投标人或投标人推选的代表<br>招标人委托的公证机构<br>地方政府相关行政主管部门<br>招标代理机构	B|C	开标时，由投标人或者其推选的代表检查投标文件的密封情况，也可以由招标人委托的公证机构检查并公证；经确认无误后，由工作人员当众拆封，宣读投标人名称、投标价格和投标的其他主要内容。
28. 《招标投标法实施条例》对于开标的规定，下列表述正确的有{{c1::（）}}。	投标人对开标有异议的，应当在开标现场提出，招标人应当当场作出答复，并制作记录<br>投标人对开标有异议的，应当在开标当日3日内提出，招标人应当作出答复，并制作记录<br>投标人少于3个的，不得开标<br>投标人少于5个的，不得开标<br>招标人应当按照招标文件规定的时间、地点开标	A|C|E	《招标投标法》规定，开标应当在招标文件确定的提交投标文件截止时间的同一时间公开进行；开标地点应当为招标文件中预先确定的地点。《招标投标法实施条例》规定，招标人应当按照招标文件规定的时间、地点开标。投标人少于3个的，不得开标；招标人应当重新招标。投标人对开标有异议的，应当在开标现场提出，招标人应当当场作出答复，并制作记录。
29. 下列关于评标委员会的规定正确的有{{c1::（）}}。	评标委员会的成员人数为5人以上单数<br>评标委员会成员中，技术、经济等方面的专家不得少于成员总数的2/3<br>评标委员会成员名单在中标结果确定前应当保密<br>评标委员会成员不得私下接触投标人<br>评标委员会由招标代理机构负责组建	A|B|C|D	《招标投标法》第三十七条规定，评标由招标人依法组建的评标委员会负责。依法必须进行招标的项目，其评标委员会由招标人的代表和有关技术、经济等方面的专家组成，成员人数为5人以上单数，其中技术、经济等方面的专家不得少于成员总数的2/3。评标委员会成员的名单在中标结果确定前应当保密。第四十四条规定，评标委员会成员不得私下接触投标人，不得收受投标人的财物或者其他好处。
30. 某政府投资的工程项目向社会公开招标，并成立了评标委员会，该项目技术特别复杂、专业性要求特别高，则下列说法正确的有{{c1::（）}}。	评标委员会由该市的建设行政主管部门负责组建<br>评标委员会成员的名单在开标时予以公布<br>评标委员会由9人组成，其中技术、经济等方面的专家为6人<br>评标委员会的专家成员可以由招标人直接确定<br>招标人可以直接授权评标委员会确定中标人	C|D|E	A项，《招标投标法》第三十七条第一款规定，评标由招标人依法组建的评标委员会负责；B项，第三十七条第五款规定，评标委员会成员名单在中标结果确定前应当保密。
31. 按照《招标投标法实施条例》的规定，下列投标应该被否决的有{{c1::（）}}。	投标文件未经投标单位负责人签字<br>投标人提交投标文件后，又在投标截止日期前一天，书面提出报价降低2%<br>招标文件规定的进度要求为36个月，投标文件中确定工期为34个月<br>投标文件中明显报价计算错误，评委会书面通知该投标人。投标人书面澄清，并未超出投标文件的范围，也未改变投标文件的实质性内容<br>投标联合体没有提交共同投标协议	A|E	有下列情形之一的，评标委员会应当否决其投标：①投标文件未经投标单位盖章和单位负责人签字；②投标联合体没有提交共同投标协议；③投标人不符合国家或者招标文件规定的资格条件；④同一投标人提交两个以上不同的投标文件或者投标报价，但招标文件要求提交备选投标的除外；⑤投标报价低于成本或者高于招标文件设定的最高投标限价；⑥投标文件没有对招标文件的实质性要求和条件作出响应；⑦投标人有串通投标、弄虚作假、行贿等违法行为。
32. A公司和B公司联合投标竞争C房地产开发公司新建住宅小区的施工工程项目，双方在共同投标协议中约定各提供40万元的投标保证金，中标后双方共同完成施工，平均分配工程款，平均承担产生的亏损和债务。但是在中标后，由于A公司的主要施工力量正在国外进行工程施工无法完成标书所载工作，A公司退出联合体拒绝与C公司签订工程承包合同。因此给C公司造成300万元的损失。在本案中C公司享有的权利有{{c1::（）}}。	不退还A公司40万元的投标保证金，但应退还B公司40万元的投标保证金<br>不退还A公司和B公司共计80万元的投标保证金<br>向A公司或B公司要求赔偿220万元<br>向A公司要求赔偿220万元，不得向B公司要求赔偿<br>向A公司和B公司各自索赔110万元	B|C|E	《招标投标法》第三十一条第三款规定，联合体各方应当签订共同投标协议，明确约定各方拟承担的工作和责任，并将共同投标协议连同投标文件一并提交招标人。联合体中标的，联合体各方应当共同与招标人签订合同，就中标项目向招标人承担连带责任。因此，A公司和B公司应承担连带责任，C公司可以要求任一公司承担赔偿责任。
33. 下列关于投标保证金的说法，正确的有{{c1::（）}}。	投标人应当按照招标文件的要求提交投标保证金<br>投标保证金是投标文件的有效组成部分<br>投标保证金的担保形式应在招标文件中规定<br>投标保证金应当在投标截止时间之前送达<br>投标保证金的金额一般由双方约定	A|B|C|D	E项，投标保证金是指投标人按照招标文件的要求向招标人出具的，以一定金额表示的投标责任担保。其实质是为了避免因投标人在投标有效期内随意撤回、撤销投标或中标后不能提交履约保证金和签署合同等行为而给招标人造成损失。
34. 在建设工程项目的招投标活动中，某投标人以低于成本的报价竞标，则{{c1::（）}}。	该行为目的是为了排挤其他对手，应当禁止<br>没有违背诚实信用原则，不应禁止<br>降低了工程造价，应当提倡<br>该投标文件应作废标处理<br>其做法符合低价中标原则，不应禁止	A|D	《招标投标法》第三十三条规定，投标人不得以低于成本的报价竞标，也不得以他人名义投标或者以其他方式弄虚作假，骗取中标。因此，若投标人以低于成本的报价竞标，则违反了法律的强制性规定，应作废标处理。
35. 招标人A公司根据评标委员会的评审报告和推荐确定B公司为中标人，根据《招标投标法》的有关规定，B公司的投标文件应当满足的条件包括{{c1::（）}}。	投标价格最低，甚至低于成本价<br>能够最大限度地满足招标文件中规定的各项综合评价标准<br>能够满足招标文件的实质性要求，并且经评审的投标价格最低，但低于成本价<br>能够基本满足招标文件中规定的各项综合评价标准<br>能够满足招标文件的实质性要求，并且经评审的投标价格最低，但不低于成本价	B|E	《招标投标法》第四十一条规定，中标人的投标应当符合下列条件之一：①能够最大限度地满足招标文件中规定的各项综合评价标准。②能够满足招标文件的实质性要求，并且经评审的投标价格最低；但是投标价格低于成本的除外。
36. 根据《工程建设项目施工招标投标办法》的规定，使用国有资金投资或者国家融资的项目，招标人应当确定排名第一的中标候选人为中标人。但是，排名第一的中标候选人{{c1::（）}}的，招标人可以确定排名第二的中标候选人为中标人。	放弃中标项目<br>投标报价低于其企业成本价<br>因不可抗力提出不能履行合同<br>与评标专家成员有利害关系<br>未在招标文件规定的期限内提交履约保证金	A|C|E	《招标投标法实施条例》第五十五条规定，国有资金占控股或者主导地位的依法必须进行招标的项目，招标人应当确定排名第一的中标候选人为中标人。排名第一的中标候选人放弃中标、因不可抗力不能履行合同、不按照招标文件要求提交履约保证金，或者被查实存在影响中标结果的违法行为等情形，不符合中标条件的，招标人可以按照评标委员会提出的中标候选人名单排序依次确定其他中标候选人为中标人，也可以重新招标。
37. 招标人在评标委员会依法推荐的中标候选人以外确定中标人的，下列说法正确的是{{c1::（）}}。	给予警告<br>处以罚款<br>对单位直接负责的主管人员依法给予处分<br>对其他直接责任人员依法给予处分<br>中标无效	B|C|D|E	《招标投标法》第五十七条规定，招标人在评标委员会依法推荐的中标候选人以外确定中标人的，依法必须进行招标的项目在所有投标被评标委员会否决后自行确定中标人的，中标无效。责令改正，可以处中标项目金额5‰以上10‰以下的罚款；对单位直接负责的主管人员和其他直接责任人员依法给予处分。
38. 招标人与中标人不按照招标文件和中标人的投标文件订立合同的，其处罚措施有{{c1::（）}}。	责令改正<br>可以处中标金额5%以上10%以下的罚款<br>可以处中标金额5‰以上10‰以下的罚款<br>取消中标人中标资格<br>对直接责任人给予罚款	A|C	《招标投标法》第五十九条规定，招标人与中标人不按照招标文件和中标人的投标文件订立合同的，或者招标人、中标人订立背离合同实质性内容的协议的，责令改正；可以处中标项目金额5‰以上10‰以下的罚款。
